BIPA	GRAPHEME	FEATURES	LATEX
<NA>		empty:empty:	
dz̫	d͡z͎	dental:affricate:+voice	\t{d͡\begin{IPA}\whistle{z}\end{IPA}}
dz̫ʰ	d͡z͎ʰ	dental:affricate:+voice +spread glottis	\t{d͡\begin{IPA}\whistle{z}\end{IPA}} extsuperscript{h}
dz̫ʰː	d͡z͎ʰː	dental:affricate:+voice +spread glottis	\t{d͡\begin{IPA}\whistle{z}\end{IPA}} extsuperscript{h}\textlengthmark
dz̫ʲ	d͡z͎ʲ	dental, palatal:affricate:+voice	\t{d͡\begin{IPA}\whistle{z}\end{IPA}}\super j
dz̫ʲː	d͡z͎ʲː	dental, palatal:affricate:+voice	\t{d͡\begin{IPA}\whistle{z}\end{IPA}}\super j\textlengthmark
dz̫ʷ	d͡z͎ʷ	dental, labial:affricate:+voice	\t{d͡\begin{IPA}\whistle{z}\end{IPA}}\super w
dz̫ʷː	d͡z͎ʷː	dental, labial:affricate:+voice	\t{d͡\begin{IPA}\whistle{z}\end{IPA}}\super w\textlengthmark
dz̫ː	d͡z͎ː	dental:affricate:+voice	\t{d͡\begin{IPA}\whistle{z}\end{IPA}}\textlengthmark
s̫	s͎	alveolar:fricative:−voice	\begin{IPA}\whistle{s}\end{IPA}
s̫ʲ	s͎ʲ	alveolar, palatal:fricative:−voice	\begin{IPA}\whistle{s}\end{IPA}\super j
s̫ʲː	s͎ʲː	alveolar, palatal:fricative:−voice	\begin{IPA}\whistle{s}\end{IPA}\super j\textlengthmark
s̫ʷ	s͎ʷ	alveolar, labial:fricative:−voice	\begin{IPA}\whistle{s}\end{IPA}\super w
s̫ʷː	s͎ʷː	alveolar, labial:fricative:−voice	\begin{IPA}\whistle{s}\end{IPA}\super w\textlengthmark
s̫ː	s͎ː	alveolar:fricative:−voice	\begin{IPA}\whistle{s}\end{IPA}\textlengthmark
ts̫	t͡s͎	alveolar:affricate:−voice	\t{t͡\begin{IPA}\whistle{s}\end{IPA}}
ts̫ʰ	t͡s͎ʰ	alveolar:affricate:−voice +spread glottis	\t{t͡\begin{IPA}\whistle{s}\end{IPA}} extsuperscript{h}
ts̫ʰː	t͡s͎ʰː	alveolar:affricate:−voice +spread glottis	\t{t͡\begin{IPA}\whistle{s}\end{IPA}} extsuperscript{h}\textlengthmark
ts̫ʲ	t͡s͎ʲ	alveolar, palatal:affricate:−voice	\t{t͡\begin{IPA}\whistle{s}\end{IPA}}\super j
ts̫ʲː	t͡s͎ʲː	alveolar, palatal:affricate:−voice	\t{t͡\begin{IPA}\whistle{s}\end{IPA}}\super j\textlengthmark
ts̫ʷ	t͡s͎ʷ	alveolar, labial:affricate:−voice	\t{t͡\begin{IPA}\whistle{s}\end{IPA}}\super w
ts̫ʷː	t͡s͎ʷː	alveolar, labial:affricate:−voice	\t{t͡\begin{IPA}\whistle{s}\end{IPA}}\super w\textlengthmark
ts̫ː	t͡s͎ː	alveolar:affricate:−voice	\t{t͡\begin{IPA}\whistle{s}\end{IPA}}\textlengthmark
<NA>	t͡ɬ̲	alveolar:affricate:+voice +lateral	\t{t͡\textsubbar{\textbeltl}}
<NA>	t͡ɬ̲ʰ	alveolar:affricate:+voice +lateral +spread glottis	\t{t͡\textsubbar{\textbeltl}} extsuperscript{h}
<NA>	t͡ɬ̲ʰː	alveolar:affricate:+voice +lateral +spread glottis	\t{t͡\textsubbar{\textbeltl}} extsuperscript{h}\textlengthmark
<NA>	t͡ɬ̲ʲ	alveolar, palatal:affricate:+voice +lateral	\t{t͡\textsubbar{\textbeltl}}\super j
<NA>	t͡ɬ̲ʲː	alveolar, palatal:affricate:+voice +lateral	\t{t͡\textsubbar{\textbeltl}}\super j\textlengthmark
<NA>	t͡ɬ̲ʷ	alveolar, labial:affricate:+voice +lateral	\t{t͡\textsubbar{\textbeltl}}\super w
<NA>	t͡ɬ̲ʷː	alveolar, labial:affricate:+voice +lateral	\t{t͡\textsubbar{\textbeltl}}\super w\textlengthmark
<NA>	t͡ɬ̲ː	alveolar:affricate:+voice +lateral	\t{t͡\textsubbar{\textbeltl}}\textlengthmark
z̫	z͎	alveolar:fricative:+voice	\begin{IPA}\whistle{z}\end{IPA}
z̫ʲ	z͎ʲ	alveolar, palatal:fricative:+voice	\begin{IPA}\whistle{z}\end{IPA}\super j
z̫ʲː	z͎ʲː	alveolar, palatal:fricative:+voice	\begin{IPA}\whistle{z}\end{IPA}\super j\textlengthmark
z̫ʷ	z͎ʷ	alveolar, labial:fricative:+voice	\begin{IPA}\whistle{z}\end{IPA}\super w
z̫ʷː	z͎ʷː	alveolar, labial:fricative:+voice	\begin{IPA}\whistle{z}\end{IPA}\super w\textlengthmark
z̫ː	z͎ː	alveolar:fricative:+voice	\begin{IPA}\whistle{z}\end{IPA}\textlengthmark
<NA>	ɹ̪	dental:liquid:+voice −lateral	\textsubbridge{\textturnr}
<NA>	ɹ̪ʲ	dental, palatal:liquid:+voice −lateral	\textsubbridge{\textturnr}\super j
<NA>	ɺ̪	dental:liquid:+voice +lateral	\textsubbridge{\textturnlonglegr}
<NA>	ɺ̪ʲ	dental, palatal:liquid:+voice +lateral	\textsubbridge{\textturnlonglegr}\super j
	d̠͡ɮ̠	dental:affricate:+voice +lateral	\t{\textsubbar{d}͡\textsubbar{\textlyoghlig}}
	d̠͡ɮ̠ʰ	dental:affricate:+voice +lateral +spread glottis	\t{\textsubbar{d}͡\textsubbar{\textlyoghlig}} extsuperscript{h}
	d̠͡ɮ̠ʰː	dental:affricate:+voice +lateral +spread glottis	\t{\textsubbar{d}͡\textsubbar{\textlyoghlig}} extsuperscript{h}\textlengthmark
	d̠͡ɮ̠ʲ	dental, palatal:affricate:+voice +lateral	\t{\textsubbar{d}͡\textsubbar{\textlyoghlig}}\super j
	d̠͡ɮ̠ʲː	dental, palatal:affricate:+voice +lateral	\t{\textsubbar{d}͡\textsubbar{\textlyoghlig}}\super j\textlengthmark
	d̠͡ɮ̠ʷ	dental, labial:affricate:+voice +lateral	\t{\textsubbar{d}͡\textsubbar{\textlyoghlig}}\super w
	d̠͡ɮ̠ʷː	dental, labial:affricate:+voice +lateral	\t{\textsubbar{d}͡\textsubbar{\textlyoghlig}}\super w\textlengthmark
	d̠͡ɮ̠ː	dental:affricate:+voice +lateral	\t{\textsubbar{d}͡\textsubbar{\textlyoghlig}}\textlengthmark
	d̪͡ɮ̪	dental:affricate:+voice +lateral	\t{\textsubbridge{d}͡\textsubbridge{\textlyoghlig}}
	d̪͡ɮ̪ʰ	dental:affricate:+voice +lateral +spread glottis	\t{\textsubbridge{d}͡\textsubbridge{\textlyoghlig}} extsuperscript{h}
	d̪͡ɮ̪ʰː	dental:affricate:+voice +lateral +spread glottis	\t{\textsubbridge{d}͡\textsubbridge{\textlyoghlig}} extsuperscript{h}\textlengthmark
	d̪͡ɮ̪ʲ	dental, palatal:affricate:+voice +lateral	\t{\textsubbridge{d}͡\textsubbridge{\textlyoghlig}}\super j
	d̪͡ɮ̪ʲː	dental, palatal:affricate:+voice +lateral	\t{\textsubbridge{d}͡\textsubbridge{\textlyoghlig}}\super j\textlengthmark
	d̪͡ɮ̪ʷ	dental, labial:affricate:+voice +lateral	\t{\textsubbridge{d}͡\textsubbridge{\textlyoghlig}}\super w
	d̪͡ɮ̪ʷː	dental, labial:affricate:+voice +lateral	\t{\textsubbridge{d}͡\textsubbridge{\textlyoghlig}}\super w\textlengthmark
	d̪͡ɮ̪ː	dental:affricate:+voice +lateral	\t{\textsubbridge{d}͡\textsubbridge{\textlyoghlig}}\textlengthmark
a	a	empty:vowel:−high +low +back −round +voice −nasal −spread glottis −constricted glottis	a
aː	aː	empty:vowel:−high +low +back −round +voice −nasal −spread glottis −constricted glottis	a\textlengthmark
ã	ã	empty:vowel:−high +low +back −round +voice +nasal −spread glottis −constricted glottis	\textipa{\~a}
ãː	ãː	empty:vowel:−high +low +back −round +voice +nasal −spread glottis −constricted glottis	\textipa{\~a}\textlengthmark
ḁ	ḁ	empty:vowel:−high +low +back −round −voice −nasal −spread glottis −constricted glottis	*a
ḁː	ḁː	empty:vowel:−high +low +back −round −voice −nasal −spread glottis −constricted glottis	*a\textlengthmark
ḁ̃	ḁ̃	empty:vowel:−high +low +back −round −voice +nasal −spread glottis −constricted glottis	*\textipa{\~a}
ḁ̃ː	ḁ̃ː	empty:vowel:−high +low +back −round −voice +nasal −spread glottis −constricted glottis	*\textipa{\~a}\textlengthmark
ḁ̯	a̯̥	empty:vowel:−high +low +back −round −voice −nasal −spread glottis −constricted glottis	*\textroundcap{a}
ḁ̯ː	a̯̥ː	empty:vowel:−high +low +back −round −voice −nasal −spread glottis −constricted glottis	*\textroundcap{a}\textlengthmark
ḁ̯̃	ã̯̥	empty:vowel:−high +low +back −round −voice +nasal −spread glottis −constricted glottis	*\textipa{\~\textroundcap{a}}
ḁ̯̃ː	ã̯̥ː	empty:vowel:−high +low +back −round −voice +nasal −spread glottis −constricted glottis	*\textipa{\~\textroundcap{a}}\textlengthmark
a̯	a̯	empty:vowel:−high +low +back −round +voice −nasal −spread glottis −constricted glottis	\textroundcap{a}
a̯ː	a̯ː	empty:vowel:−high +low +back −round +voice −nasal −spread glottis −constricted glottis	\textroundcap{a}\textlengthmark
ã̯	ã̯	empty:vowel:−high +low +back −round +voice +nasal −spread glottis −constricted glottis	\textipa{\~\textroundcap{a}}
ã̯ː	ã̯ː	empty:vowel:−high +low +back −round +voice +nasal −spread glottis −constricted glottis	\textipa{\~\textroundcap{a}}\textlengthmark
b	b	labial:plosive:+voice	b
bd	b͡d	labial, alveolar:plosive:+voice	\t{b͡d}
bdʰ	b͡dʰ	labial, alveolar:plosive:+voice +spread glottis	\t{b͡d} extsuperscript{h}
bdʰː	b͡dʰː	labial, alveolar:plosive:+voice +spread glottis	\t{b͡d} extsuperscript{h}\textlengthmark
bdʲ	b͡dʲ	labial, alveolar, palatal:plosive:+voice	\t{b͡d}\super j
bdʲː	b͡dʲː	labial, alveolar, palatal:plosive:+voice	\t{b͡d}\super j\textlengthmark
bdʷ	b͡dʷ	labial, alveolar:plosive:+voice	\t{b͡d}\super w
bdʷː	b͡dʷː	labial, alveolar:plosive:+voice	\t{b͡d}\super w\textlengthmark
bdː	b͡dː	labial, alveolar:plosive:+voice	\t{b͡d}\textlengthmark
bv	b͡v	labiodental:affricate:+voice	\t{b͡v}
bvʰ	b͡vʰ	labiodental:affricate:+voice +spread glottis	\t{b͡v} extsuperscript{h}
bvʰː	b͡vʰː	labiodental:affricate:+voice +spread glottis	\t{b͡v} extsuperscript{h}\textlengthmark
bvʲ	b͡vʲ	labiodental, palatal:affricate:+voice	\t{b͡v}\super j
bvʲː	b͡vʲː	labiodental, palatal:affricate:+voice	\t{b͡v}\super j\textlengthmark
bvʷ	b͡vʷ	labiodental, labial:affricate:+voice	\t{b͡v}\super w
bvʷː	b͡vʷː	labiodental, labial:affricate:+voice	\t{b͡v}\super w\textlengthmark
bvː	b͡vː	labiodental:affricate:+voice	\t{b͡v}\textlengthmark
bʰ	bʰ	labial:plosive:+voice +spread glottis	b extsuperscript{h}
bʰː	bʰː	labial:plosive:+voice +spread glottis	b extsuperscript{h}\textlengthmark
bʲ	bʲ	labial, palatal:plosive:+voice	b\super j
bʲʰ	bʰʲ	labial, palatal:plosive:+voice +spread glottis	b extsuperscript{h}\super j
bʲʰː	bʰʲː	labial, palatal:plosive:+voice +spread glottis	b extsuperscript{h}\super j\textlengthmark
bʲː	bʲː	labial, palatal:plosive:+voice	b\super j\textlengthmark
bʷ	bʷ	labial:plosive:+voice	b\super w
bʷʰ	bʰʷ	labial:plosive:+voice +spread glottis	b extsuperscript{h}\super w
bʷʰː	bʰʷː	labial:plosive:+voice +spread glottis	b extsuperscript{h}\super w\textlengthmark
bʷː	bʷː	labial:plosive:+voice	b\super w\textlengthmark
bː	bː	labial:plosive:+voice	b\textlengthmark
b̩	b̩	labial:plosive:+voice +syllabic	\textipa{\s{b}}
b̩ʲ	b̩ʲ	labial, palatal:plosive:+voice +syllabic	\textipa{\s{b}}\super j
b̩ʲː	b̩ʲː	labial, palatal:plosive:+voice +syllabic	\textipa{\s{b}}\super j\textlengthmark
b̩ʷ	b̩ʷ	labial:plosive:+voice +syllabic	\textipa{\s{b}}\super w
b̩ʷː	b̩ʷː	labial:plosive:+voice +syllabic	\textipa{\s{b}}\super w\textlengthmark
b̩ː	b̩ː	labial:plosive:+voice +syllabic	\textipa{\s{b}}\textlengthmark
bβ	b͡β	labial:affricate:+voice	\t{b͡\textipa{B}}
bβʰ	b͡βʰ	labial:affricate:+voice +spread glottis	\t{b͡\textipa{B}} extsuperscript{h}
bβʰː	b͡βʰː	labial:affricate:+voice +spread glottis	\t{b͡\textipa{B}} extsuperscript{h}\textlengthmark
bβʲ	b͡βʲ	labial, palatal:affricate:+voice	\t{b͡\textipa{B}}\super j
bβʲː	b͡βʲː	labial, palatal:affricate:+voice	\t{b͡\textipa{B}}\super j\textlengthmark
bβʷ	b͡βʷ	labial:affricate:+voice	\t{b͡\textipa{B}}\super w
bβʷː	b͡βʷː	labial:affricate:+voice	\t{b͡\textipa{B}}\super w\textlengthmark
bβː	b͡βː	labial:affricate:+voice	\t{b͡\textipa{B}}\textlengthmark
c	c	palatal:plosive:−voice	c
cç	c͡ç	palatal:affricate:−voice	\t{c\c{c}}
cçʰ	c͡çʰ	palatal:affricate:−voice +spread glottis	\t{c\c{c}} extsuperscript{h}
cçʰː	c͡çʰː	palatal:affricate:−voice +spread glottis	\t{c\c{c}} extsuperscript{h}\textlengthmark
cçʲ	c͡çʲ	palatal:affricate:−voice	\t{c\c{c}}\super j
cçʲː	c͡çʲː	palatal:affricate:−voice	\t{c\c{c}}\super j\textlengthmark
cçʷ	c͡çʷ	palatal, labial:affricate:−voice	\t{c\c{c}}\super w
cçʷː	c͡çʷː	palatal, labial:affricate:−voice	\t{c\c{c}}\super w\textlengthmark
cçː	c͡çː	palatal:affricate:−voice	\t{c\c{c}}\textlengthmark
cʰ	cʰ	palatal:plosive:−voice +spread glottis	c extsuperscript{h}
cʰː	cʰː	palatal:plosive:−voice +spread glottis	c extsuperscript{h}\textlengthmark
cʲ	cʲ	palatal:plosive:−voice	c\super j
cʲʰ	cʰʲ	palatal:plosive:−voice +spread glottis	c extsuperscript{h}\super j
cʲʰː	cʰʲː	palatal:plosive:−voice +spread glottis	c extsuperscript{h}\super j\textlengthmark
cʲː	cʲː	palatal:plosive:−voice	c\super j\textlengthmark
cʷ	cʷ	palatal, labial:plosive:−voice	c\super w
cʷʰ	cʰʷ	palatal, labial:plosive:−voice +spread glottis	c extsuperscript{h}\super w
cʷʰː	cʰʷː	palatal, labial:plosive:−voice +spread glottis	c extsuperscript{h}\super w\textlengthmark
cʷː	cʷː	palatal, labial:plosive:−voice	c\super w\textlengthmark
cː	cː	palatal:plosive:−voice	c\textlengthmark
ç	ç	palatal:fricative:−voice	\c{c}
çʲ	çʲ	palatal:fricative:−voice	\c{c}\super j
çʲː	çʲː	palatal:fricative:−voice	\c{c}\super j\textlengthmark
çʷ	çʷ	palatal, labial:fricative:−voice	\c{c}\super w
çʷː	çʷː	palatal, labial:fricative:−voice	\c{c}\super w\textlengthmark
çː	çː	palatal:fricative:−voice	\c{c}\textlengthmark
ç̩	ç̩	palatal:fricative:−voice +syllabic	\textipa{\s{\c{c}}}
ç̩ʲ	ç̩ʲ	palatal:fricative:−voice +syllabic	\textipa{\s{\c{c}}}\super j
ç̩ʲː	ç̩ʲː	palatal:fricative:−voice +syllabic	\textipa{\s{\c{c}}}\super j\textlengthmark
ç̩ʷ	ç̩ʷ	palatal, labial:fricative:−voice +syllabic	\textipa{\s{\c{c}}}\super w
ç̩ʷː	ç̩ʷː	palatal, labial:fricative:−voice +syllabic	\textipa{\s{\c{c}}}\super w\textlengthmark
ç̩ː	ç̩ː	palatal:fricative:−voice +syllabic	\textipa{\s{\c{c}}}\textlengthmark
c̩	c̩	palatal:plosive:−voice +syllabic	\textipa{\s{c}}
c̩ʲ	c̩ʲ	palatal:plosive:−voice +syllabic	\textipa{\s{c}}\super j
c̩ʲː	c̩ʲː	palatal:plosive:−voice +syllabic	\textipa{\s{c}}\super j\textlengthmark
c̩ʷ	c̩ʷ	palatal, labial:plosive:−voice +syllabic	\textipa{\s{c}}\super w
c̩ʷː	c̩ʷː	palatal, labial:plosive:−voice +syllabic	\textipa{\s{c}}\super w\textlengthmark
c̩ː	c̩ː	palatal:plosive:−voice +syllabic	\textipa{\s{c}}\textlengthmark
d	d	alveolar:plosive:+voice	d
dz	d͡z	dental:affricate:+voice	\t{dz}
dzʰ	d͡zʰ	dental:affricate:+voice +spread glottis	\t{dz} extsuperscript{h}
dzʰː	d͡zʰː	dental:affricate:+voice +spread glottis	\t{dz} extsuperscript{h}\textlengthmark
dzʲ	d͡zʲ	dental, palatal:affricate:+voice	\t{dz}\super j
dzʲː	d͡zʲː	dental, palatal:affricate:+voice	\t{dz}\super j\textlengthmark
dzʷ	d͡zʷ	dental, labial:affricate:+voice	\t{dz}\super w
dzʷː	d͡zʷː	dental, labial:affricate:+voice	\t{dz}\super w\textlengthmark
dzː	d͡zː	dental:affricate:+voice	\t{dz}\textlengthmark
dz̪	d̪͡z̪	dental:affricate:+voice	\t{\textsubbridge{d}\textsubbridge{z}}
dz̪ʰ	d̪͡z̪ʰ	dental:affricate:+voice +spread glottis	\t{\textsubbridge{d}\textsubbridge{z}} extsuperscript{h}
dz̪ʰː	d̪͡z̪ʰː	dental:affricate:+voice +spread glottis	\t{\textsubbridge{d}\textsubbridge{z}} extsuperscript{h}\textlengthmark
dz̪ʲ	d̪͡z̪ʲ	dental, palatal:affricate:+voice	\t{\textsubbridge{d}\textsubbridge{z}}\super j
dz̪ʲː	d̪͡z̪ʲː	dental, palatal:affricate:+voice	\t{\textsubbridge{d}\textsubbridge{z}}\super j\textlengthmark
dz̪ʷ	d̪͡z̪ʷ	dental, labial:affricate:+voice	\t{\textsubbridge{d}\textsubbridge{z}}\super w
dz̪ʷː	d̪͡z̪ʷː	dental, labial:affricate:+voice	\t{\textsubbridge{d}\textsubbridge{z}}\super w\textlengthmark
dz̪ː	d̪͡z̪ː	dental:affricate:+voice	\t{\textsubbridge{d}\textsubbridge{z}}\textlengthmark
dð	d̪͡ð	dental:affricate:+voice	\t{\textsubbridge{d}͡ð}
dðʰ	d̪͡ðʰ	dental:affricate:+voice +spread glottis	\t{\textsubbridge{d}͡ð} extsuperscript{h}
dðʰː	d̪͡ðʰː	dental:affricate:+voice +spread glottis	\t{\textsubbridge{d}͡ð} extsuperscript{h}\textlengthmark
dðʲ	d̪͡ðʲ	dental, palatal:affricate:+voice	\t{\textsubbridge{d}͡ð}\super j
dðʲː	d̪͡ðʲː	dental, palatal:affricate:+voice	\t{\textsubbridge{d}͡ð}\super j\textlengthmark
dðʷ	d̪͡ðʷ	dental, labial:affricate:+voice	\t{\textsubbridge{d}͡ð}\super w
dðʷː	d̪͡ðʷː	dental, labial:affricate:+voice	\t{\textsubbridge{d}͡ð}\super w\textlengthmark
dðː	d̪͡ðː	dental:affricate:+voice	\t{\textsubbridge{d}͡ð}\textlengthmark
dɮ	d͡ɮ	alveolar:affricate:+voice +lateral	\t{d͡\textlyoghlig}
dɮʰ	d͡ɮʰ	alveolar:affricate:+voice +lateral +spread glottis	\t{d͡\textlyoghlig} extsuperscript{h}
dɮʰː	d͡ɮʰː	alveolar:affricate:+voice +lateral +spread glottis	\t{d͡\textlyoghlig} extsuperscript{h}\textlengthmark
dɮʲ	d͡ɮʲ	alveolar, palatal:affricate:+voice +lateral	\t{d͡\textlyoghlig}\super j
dɮʲː	d͡ɮʲː	alveolar, palatal:affricate:+voice +lateral	\t{d͡\textlyoghlig}\super j\textlengthmark
dɮʷ	d͡ɮʷ	alveolar, labial:affricate:+voice +lateral	\t{d͡\textlyoghlig}\super w
dɮʷː	d͡ɮʷː	alveolar, labial:affricate:+voice +lateral	\t{d͡\textlyoghlig}\super w\textlengthmark
dɮː	d͡ɮː	alveolar:affricate:+voice +lateral	\t{d͡\textlyoghlig}\textlengthmark
dʑ	d͡ʑ	alveolar, palatal:affricate:+voice	\t{d͡\textctz}
dʑʰ	d͡ʑʰ	alveolar, palatal:affricate:+voice +spread glottis	\t{d͡\textctz} extsuperscript{h}
dʑʰː	d͡ʑʰː	alveolar, palatal:affricate:+voice +spread glottis	\t{d͡\textctz} extsuperscript{h}\textlengthmark
dʑʲ	d͡ʑʲ	alveolar, palatal:affricate:+voice	\t{d͡\textctz}\super j
dʑʲː	d͡ʑʲː	alveolar, palatal:affricate:+voice	\t{d͡\textctz}\super j\textlengthmark
dʑʷ	d͡ʑʷ	alveolar, palatal, labial:affricate:+voice	\t{d͡\textctz}\super w
dʑʷː	d͡ʑʷː	alveolar, palatal, labial:affricate:+voice	\t{d͡\textctz}\super w\textlengthmark
dʑː	d͡ʑː	alveolar, palatal:affricate:+voice	\t{d͡\textctz}\textlengthmark
dʒ	d͡ʒ	palatoalveolar:affricate:+voice	\t{d͡\textyogh}
dʒʰ	d͡ʒʰ	palatoalveolar:affricate:+voice +spread glottis	\t{d͡\textyogh} extsuperscript{h}
dʒʰː	d͡ʒʰː	palatoalveolar:affricate:+voice +spread glottis	\t{d͡\textyogh} extsuperscript{h}\textlengthmark
dʒʲ	d͡ʒʲ	palatoalveolar, palatal:affricate:+voice	\t{d͡\textyogh}\super j
dʒʲː	d͡ʒʲː	palatoalveolar, palatal:affricate:+voice	\t{d͡\textyogh}\super j\textlengthmark
dʒʷ	d͡ʒʷ	palatoalveolar, labial:affricate:+voice	\t{d͡\textyogh}\super w
dʒʷː	d͡ʒʷː	palatoalveolar, labial:affricate:+voice	\t{d͡\textyogh}\super w\textlengthmark
dʒː	d͡ʒː	palatoalveolar:affricate:+voice	\t{d͡\textyogh}\textlengthmark
dʰ	dʰ	alveolar:plosive:+voice +spread glottis	d extsuperscript{h}
dʰː	dʰː	alveolar:plosive:+voice +spread glottis	d extsuperscript{h}\textlengthmark
dʲ	dʲ	alveolar, palatal:plosive:+voice	d\super j
dʲʰ	dʰʲ	alveolar, palatal:plosive:+voice +spread glottis	d extsuperscript{h}\super j
dʲʰː	dʰʲː	alveolar, palatal:plosive:+voice +spread glottis	d extsuperscript{h}\super j\textlengthmark
dʲː	dʲː	alveolar, palatal:plosive:+voice	d\super j\textlengthmark
dʷ	dʷ	alveolar, labial:plosive:+voice	d\super w
dʷʰ	dʰʷ	alveolar, labial:plosive:+voice +spread glottis	d extsuperscript{h}\super w
dʷʰː	dʰʷː	alveolar, labial:plosive:+voice +spread glottis	d extsuperscript{h}\super w\textlengthmark
dʷː	dʷː	alveolar, labial:plosive:+voice	d\super w\textlengthmark
dː	dː	alveolar:plosive:+voice	d\textlengthmark
d̠	d̠	dental:plosive:+voice	\textsubbar{d}
d̠ʰ	d̠ʰ	dental:plosive:+voice +spread glottis	\textsubbar{d} extsuperscript{h}
d̠ʰː	d̠ʰː	dental:plosive:+voice +spread glottis	\textsubbar{d} extsuperscript{h}\textlengthmark
d̠ʲ	d̠ʲ	dental, palatal:plosive:+voice	\textsubbar{d}\super j
d̠ʲː	d̠ʲː	dental, palatal:plosive:+voice	\textsubbar{d}\super j\textlengthmark
d̠ʷ	d̠ʷ	dental, labial:plosive:+voice	\textsubbar{d}\super w
d̠ʷː	d̠ʷː	dental, labial:plosive:+voice	\textsubbar{d}\super w\textlengthmark
d̠ː	d̠ː	dental:plosive:+voice	\textsubbar{d}\textlengthmark
d̩	d̩	alveolar:plosive:+voice +syllabic	\textipa{\s{d}}
d̩ʲ	d̩ʲ	alveolar, palatal:plosive:+voice +syllabic	\textipa{\s{d}}\super j
d̩ʲː	d̩ʲː	alveolar, palatal:plosive:+voice +syllabic	\textipa{\s{d}}\super j\textlengthmark
d̩ʷ	d̩ʷ	alveolar, labial:plosive:+voice +syllabic	\textipa{\s{d}}\super w
d̩ʷː	d̩ʷː	alveolar, labial:plosive:+voice +syllabic	\textipa{\s{d}}\super w\textlengthmark
d̩ː	d̩ː	alveolar:plosive:+voice +syllabic	\textipa{\s{d}}\textlengthmark
d̪	d̪	dental:plosive:+voice	\textsubbridge{d}
d̪ʰ	d̪ʰ	dental:plosive:+voice +spread glottis	\textsubbridge{d} extsuperscript{h}
d̪ʰː	d̪ʰː	dental:plosive:+voice +spread glottis	\textsubbridge{d} extsuperscript{h}\textlengthmark
d̪ʲ	d̪ʲ	dental, palatal:plosive:+voice	\textsubbridge{d}\super j
d̪ʲː	d̪ʲː	dental, palatal:plosive:+voice	\textsubbridge{d}\super j\textlengthmark
d̪ʷ	d̪ʷ	dental, labial:plosive:+voice	\textsubbridge{d}\super w
d̪ʷː	d̪ʷː	dental, labial:plosive:+voice	\textsubbridge{d}\super w\textlengthmark
d̪ː	d̪ː	dental:plosive:+voice	\textsubbridge{d}\textlengthmark
e	e	empty:vowel:−high −low −back −round +voice −nasal −spread glottis −constricted glottis	e
eː	eː	empty:vowel:−high −low −back −round +voice −nasal −spread glottis −constricted glottis	e\textlengthmark
ẽ	ẽ	empty:vowel:−high −low −back −round +voice +nasal −spread glottis −constricted glottis	\textipa{\~e}
ẽː	ẽː	empty:vowel:−high −low −back −round +voice +nasal −spread glottis −constricted glottis	\textipa{\~e}\textlengthmark
e̥	e̥	empty:vowel:−high −low −back −round −voice −nasal −spread glottis −constricted glottis	*e
e̥ː	e̥ː	empty:vowel:−high −low −back −round −voice −nasal −spread glottis −constricted glottis	*e\textlengthmark
ẽ̥	ẽ̥	empty:vowel:−high −low −back −round −voice +nasal −spread glottis −constricted glottis	*\textipa{\~e}
ẽ̥ː	ẽ̥ː	empty:vowel:−high −low −back −round −voice +nasal −spread glottis −constricted glottis	*\textipa{\~e}\textlengthmark
e̥̯	e̯̥	empty:vowel:−high −low −back −round −voice −nasal −spread glottis −constricted glottis	*\textroundcap{e}
e̥̯ː	e̯̥ː	empty:vowel:−high −low −back −round −voice −nasal −spread glottis −constricted glottis	*\textroundcap{e}\textlengthmark
ẽ̥̯	ẽ̯̥	empty:vowel:−high −low −back −round −voice +nasal −spread glottis −constricted glottis	*\textipa{\~\textroundcap{e}}
ẽ̥̯ː	ẽ̯̥ː	empty:vowel:−high −low −back −round −voice +nasal −spread glottis −constricted glottis	*\textipa{\~\textroundcap{e}}\textlengthmark
e̯	e̯	empty:vowel:−high −low −back −round +voice −nasal −spread glottis −constricted glottis	\textroundcap{e}
e̯ː	e̯ː	empty:vowel:−high −low −back −round +voice −nasal −spread glottis −constricted glottis	\textroundcap{e}\textlengthmark
ẽ̯	ẽ̯	empty:vowel:−high −low −back −round +voice +nasal −spread glottis −constricted glottis	\textipa{\~\textroundcap{e}}
ẽ̯ː	ẽ̯ː	empty:vowel:−high −low −back −round +voice +nasal −spread glottis −constricted glottis	\textipa{\~\textroundcap{e}}\textlengthmark
f	f	labiodental:fricative:−voice	f
fʲ	fʲ	labiodental, palatal:fricative:−voice	f\super j
fʲː	fʲː	labiodental, palatal:fricative:−voice	f\super j\textlengthmark
fʷ	fʷ	labiodental, labial:fricative:−voice	f\super w
fʷː	fʷː	labiodental, labial:fricative:−voice	f\super w\textlengthmark
fː	fː	labiodental:fricative:−voice	f\textlengthmark
f̩	f̩	labiodental:fricative:−voice +syllabic	\textipa{\s{f}}
f̩ʲ	f̩ʲ	labiodental, palatal:fricative:−voice +syllabic	\textipa{\s{f}}\super j
f̩ʲː	f̩ʲː	labiodental, palatal:fricative:−voice +syllabic	\textipa{\s{f}}\super j\textlengthmark
f̩ʷ	f̩ʷ	labiodental, labial:fricative:−voice +syllabic	\textipa{\s{f}}\super w
f̩ʷː	f̩ʷː	labiodental, labial:fricative:−voice +syllabic	\textipa{\s{f}}\super w\textlengthmark
f̩ː	f̩ː	labiodental:fricative:−voice +syllabic	\textipa{\s{f}}\textlengthmark
g	ɡ	velar:plosive:+voice	ɡ
gb	ɡ͡b	labial, velar:plosive:+voice	\t{g͡b}
gbʰ	ɡ͡bʰ	labial, velar:plosive:+voice +spread glottis	\t{g͡b} extsuperscript{h}
gbʰː	ɡ͡bʰː	labial, velar:plosive:+voice +spread glottis	\t{g͡b} extsuperscript{h}\textlengthmark
gbʲ	ɡ͡bʲ	labial, velar, palatal:plosive:+voice	\t{g͡b}\super j
gbʲː	ɡ͡bʲː	labial, velar, palatal:plosive:+voice	\t{g͡b}\super j\textlengthmark
gbʷ	ɡ͡bʷ	labial, velar:plosive:+voice	\t{g͡b}\super w
gbʷː	ɡ͡bʷː	labial, velar:plosive:+voice	\t{g͡b}\super w\textlengthmark
gbː	ɡ͡bː	labial, velar:plosive:+voice	\t{g͡b}\textlengthmark
gɣ	ɡ͡ɣ	velar:affricate:+voice	\t{ɡ͡\textipa{G}}
gɣʰ	ɡ͡ɣʰ	velar:affricate:+voice +spread glottis	\t{ɡ͡\textipa{G}} extsuperscript{h}
gɣʰː	ɡ͡ɣʰː	velar:affricate:+voice +spread glottis	\t{ɡ͡\textipa{G}} extsuperscript{h}\textlengthmark
gɣʲ	ɡ͡ɣʲ	velar, palatal:affricate:+voice	\t{ɡ͡\textipa{G}}\super j
gɣʲː	ɡ͡ɣʲː	velar, palatal:affricate:+voice	\t{ɡ͡\textipa{G}}\super j\textlengthmark
gɣʷ	ɡ͡ɣʷ	velar, labial:affricate:+voice	\t{ɡ͡\textipa{G}}\super w
gɣʷː	ɡ͡ɣʷː	velar, labial:affricate:+voice	\t{ɡ͡\textipa{G}}\super w\textlengthmark
gɣː	ɡ͡ɣː	velar:affricate:+voice	\t{ɡ͡\textipa{G}}\textlengthmark
gɣ̟	ɡ̟͡ɣ̟	velar:affricate:+voice	\begin{IPA} \t{\|+g \|+G} \end{IPA}
gɣ̟ʰ	ɡ̟͡ɣ̟ʰ	velar:affricate:+voice +spread glottis	\begin{IPA} \t{\|+g \|+G} \end{IPA} extsuperscript{h}
gɣ̟ʰː	ɡ̟͡ɣ̟ʰː	velar:affricate:+voice +spread glottis	\begin{IPA} \t{\|+g \|+G} \end{IPA} extsuperscript{h}\textlengthmark
gɣ̟ʲ	ɡ̟͡ɣ̟ʲ	velar, palatal:affricate:+voice	\begin{IPA} \t{\|+g \|+G} \end{IPA} \super j
gɣ̟ʲː	ɡ̟͡ɣ̟ʲː	velar, palatal:affricate:+voice	\begin{IPA} \t{\|+g \|+G} \end{IPA} \super j\textlengthmark
gɣ̟ʷ	ɡ̟͡ɣ̟ʷ	velar, labial:affricate:+voice	\begin{IPA} \t{\|+g \|+G} \end{IPA} \super w
gɣ̟ʷː	ɡ̟͡ɣ̟ʷː	velar, labial:affricate:+voice	\begin{IPA} \t{\|+g \|+G} \end{IPA} \super w\textlengthmark
gɣ̟ː	ɡ̟͡ɣ̟ː	velar:affricate:+voice	\begin{IPA} \t{\|+g \|+G} \end{IPA} \textlengthmark
gɣ̠	ɡ̠͡ɣ̠	velar:affricate:+voice	\t{\textsubbar{ɡ} \textsubbar{\textipa{G}}}
gɣ̠ʰ	ɡ̠͡ɣ̠ʰ	velar:affricate:+voice +spread glottis	\t{\textsubbar{ɡ} \textsubbar{\textipa{G}}} extsuperscript{h}
gɣ̠ʰː	ɡ̠͡ɣ̠ʰː	velar:affricate:+voice +spread glottis	\t{\textsubbar{ɡ} \textsubbar{\textipa{G}}} extsuperscript{h}\textlengthmark
gɣ̠ʲ	ɡ̠͡ɣ̠ʲ	velar, palatal:affricate:+voice	\t{\textsubbar{ɡ} \textsubbar{\textipa{G}}}\super j
gɣ̠ʲː	ɡ̠͡ɣ̠ʲː	velar, palatal:affricate:+voice	\t{\textsubbar{ɡ} \textsubbar{\textipa{G}}}\super j\textlengthmark
gɣ̠ʷ	ɡ̠͡ɣ̠ʷ	velar, labial:affricate:+voice	\t{\textsubbar{ɡ} \textsubbar{\textipa{G}}}\super w
gɣ̠ʷː	ɡ̠͡ɣ̠ʷː	velar, labial:affricate:+voice	\t{\textsubbar{ɡ} \textsubbar{\textipa{G}}}\super w\textlengthmark
gɣ̠ː	ɡ̠͡ɣ̠ː	velar:affricate:+voice	\t{\textsubbar{ɡ} \textsubbar{\textipa{G}}}\textlengthmark
gʰ	ɡʰ	velar:plosive:+voice +spread glottis	ɡ extsuperscript{h}
gʰː	ɡʰː	velar:plosive:+voice +spread glottis	ɡ extsuperscript{h}\textlengthmark
gʲ	ɡʲ	velar, palatal:plosive:+voice	ɡ\super j
gʲʰ	ɡʰʲ	velar, palatal:plosive:+voice +spread glottis	ɡ extsuperscript{h}\super j
gʲʰː	ɡʰʲː	velar, palatal:plosive:+voice +spread glottis	ɡ extsuperscript{h}\super j\textlengthmark
gʲː	ɡʲː	velar, palatal:plosive:+voice	ɡ\super j\textlengthmark
gʷ	ɡʷ	velar, labial:plosive:+voice	ɡ\super w
gʷʰ	ɡʰʷ	velar, labial:plosive:+voice +spread glottis	ɡ extsuperscript{h}\super w
gʷʰː	ɡʰʷː	velar, labial:plosive:+voice +spread glottis	ɡ extsuperscript{h}\super w\textlengthmark
gʷː	ɡʷː	velar, labial:plosive:+voice	ɡ\super w\textlengthmark
gː	ɡː	velar:plosive:+voice	ɡ\textlengthmark
g̩	ɡ̩	velar:plosive:+voice +syllabic	\textipa{\s{ɡ}}
g̩ʲ	ɡ̩ʲ	velar, palatal:plosive:+voice +syllabic	\textipa{\s{ɡ}}\super j
g̩ʲː	ɡ̩ʲː	velar, palatal:plosive:+voice +syllabic	\textipa{\s{ɡ}}\super j\textlengthmark
g̩ʷ	ɡ̩ʷ	velar, labial:plosive:+voice +syllabic	\textipa{\s{ɡ}}\super w
g̩ʷː	ɡ̩ʷː	velar, labial:plosive:+voice +syllabic	\textipa{\s{ɡ}}\super w\textlengthmark
g̩ː	ɡ̩ː	velar:plosive:+voice +syllabic	\textipa{\s{ɡ}}\textlengthmark
h	h	glottal:fricative:−voice	h
hʲ	hʲ	glottal, palatal:fricative:−voice	h\super j
hʲː	hʲː	glottal, palatal:fricative:−voice	h\super j\textlengthmark
hʷ	hʷ	glottal, labial:fricative:−voice	h\super w
hʷː	hʷː	glottal, labial:fricative:−voice	h\super w\textlengthmark
hː	hː	glottal:fricative:−voice	h\textlengthmark
h̩	h̩	glottal:fricative:−voice +syllabic	\textipa{\s{h}}
h̩ʲ	h̩ʲ	glottal, palatal:fricative:−voice +syllabic	\textipa{\s{h}}\super j
h̩ʲː	h̩ʲː	glottal, palatal:fricative:−voice +syllabic	\textipa{\s{h}}\super j\textlengthmark
h̩ʷ	h̩ʷ	glottal, labial:fricative:−voice +syllabic	\textipa{\s{h}}\super w
h̩ʷː	h̩ʷː	glottal, labial:fricative:−voice +syllabic	\textipa{\s{h}}\super w\textlengthmark
h̩ː	h̩ː	glottal:fricative:−voice +syllabic	\textipa{\s{h}}\textlengthmark
i	i	empty:vowel:+high −low −back −round +voice −nasal −spread glottis −constricted glottis	i
iː	iː	empty:vowel:+high −low −back −round +voice −nasal −spread glottis −constricted glottis	i\textlengthmark
ĩ	ĩ	empty:vowel:+high −low −back −round +voice +nasal −spread glottis −constricted glottis	\textipa{\~i}
ĩː	ĩː	empty:vowel:+high −low −back −round +voice +nasal −spread glottis −constricted glottis	\textipa{\~i}\textlengthmark
i̥	i̥	empty:vowel:+high −low −back −round −voice −nasal −spread glottis −constricted glottis	*i
i̥ː	i̥ː	empty:vowel:+high −low −back −round −voice −nasal −spread glottis −constricted glottis	*i\textlengthmark
ĩ̥	ĩ̥	empty:vowel:+high −low −back −round −voice +nasal −spread glottis −constricted glottis	*\textipa{\~i}
ĩ̥ː	ĩ̥ː	empty:vowel:+high −low −back −round −voice +nasal −spread glottis −constricted glottis	*\textipa{\~i}\textlengthmark
i̥̯	i̯̥	empty:vowel:+high −low −back −round −voice −nasal −spread glottis −constricted glottis	*\textroundcap{i}
i̥̯ː	i̯̥ː	empty:vowel:+high −low −back −round −voice −nasal −spread glottis −constricted glottis	*\textroundcap{i}\textlengthmark
ĩ̥̯	ĩ̯̥	empty:vowel:+high −low −back −round −voice +nasal −spread glottis −constricted glottis	*\textipa{\~\textroundcap{i}}
ĩ̥̯ː	ĩ̯̥ː	empty:vowel:+high −low −back −round −voice +nasal −spread glottis −constricted glottis	*\textipa{\~\textroundcap{i}}\textlengthmark
i̯	i̯	empty:vowel:+high −low −back −round +voice −nasal −spread glottis −constricted glottis	\textroundcap{i}
i̯ː	i̯ː	empty:vowel:+high −low −back −round +voice −nasal −spread glottis −constricted glottis	\textroundcap{i}\textlengthmark
ĩ̯	ĩ̯	empty:vowel:+high −low −back −round +voice +nasal −spread glottis −constricted glottis	\textipa{\~\textroundcap{i}}
ĩ̯ː	ĩ̯ː	empty:vowel:+high −low −back −round +voice +nasal −spread glottis −constricted glottis	\textipa{\~\textroundcap{i}}\textlengthmark
j	j	palatal:glide:+voice	j
j̃	j̃	palatal:glide:+voice +nasal	\textipa{\~j}
k	k	velar:plosive:−voice	k
kp	k͡p	labial, velar:plosive:−voice	\t{k͡p}
kpʰ	k͡pʰ	labial, velar:plosive:−voice +spread glottis	\t{k͡p} extsuperscript{h}
kpʰː	k͡pʰː	labial, velar:plosive:−voice +spread glottis	\t{k͡p} extsuperscript{h}\textlengthmark
kpʲ	k͡pʲ	labial, velar, palatal:plosive:−voice	\t{k͡p}\super j
kpʲː	k͡pʲː	labial, velar, palatal:plosive:−voice	\t{k͡p}\super j\textlengthmark
kpʷ	k͡pʷ	labial, velar:plosive:−voice	\t{k͡p}\super w
kpʷː	k͡pʷː	labial, velar:plosive:−voice	\t{k͡p}\super w\textlengthmark
kpː	k͡pː	labial, velar:plosive:−voice	\t{k͡p}\textlengthmark
kx	k͡x	velar:affricate:−voice	\t{kx}
kxʰ	k͡xʰ	velar:affricate:−voice +spread glottis	\t{kx} extsuperscript{h}
kxʰː	k͡xʰː	velar:affricate:−voice +spread glottis	\t{kx} extsuperscript{h}\textlengthmark
kxʲ	k͡xʲ	velar, palatal:affricate:−voice	\t{kx}\super j
kxʲː	k͡xʲː	velar, palatal:affricate:−voice	\t{kx}\super j\textlengthmark
kxʷ	k͡xʷ	velar, labial:affricate:−voice	\t{kx}\super w
kxʷː	k͡xʷː	velar, labial:affricate:−voice	\t{kx}\super w\textlengthmark
kxː	k͡xː	velar:affricate:−voice	\t{kx}\textlengthmark
kx̟	k̟͡x̟	velar:affricate:−voice	\t{\begin{IPA}\|+k̟\|+x̟\end{IPA}}
kx̟ʰ	k̟͡x̟ʰ	velar:affricate:−voice +spread glottis	\t{\begin{IPA}\|+k̟\|+x̟\end{IPA}} extsuperscript{h}
kx̟ʰː	k̟͡x̟ʰː	velar:affricate:−voice +spread glottis	\t{\begin{IPA}\|+k̟\|+x̟\end{IPA}} extsuperscript{h}\textlengthmark
kx̟ʲ	k̟͡x̟ʲ	velar, palatal:affricate:−voice	\t{\begin{IPA}\|+k̟\|+x̟\end{IPA}}\super j
kx̟ʲː	k̟͡x̟ʲː	velar, palatal:affricate:−voice	\t{\begin{IPA}\|+k̟\|+x̟\end{IPA}}\super j\textlengthmark
kx̟ʷ	k̟͡x̟ʷ	velar, labial:affricate:−voice	\t{\begin{IPA}\|+k̟\|+x̟\end{IPA}}\super w
kx̟ʷː	k̟͡x̟ʷː	velar, labial:affricate:−voice	\t{\begin{IPA}\|+k̟\|+x̟\end{IPA}}\super w\textlengthmark
kx̟ː	k̟͡x̟ː	velar:affricate:−voice	\t{\begin{IPA}\|+k̟\|+x̟\end{IPA}}\textlengthmark
kx̠	k̠͡x̠	velar:affricate:−voice	\t{\textsubbar{k}\textsubbar{x}}
kx̠ʰ	k̠͡x̠ʰ	velar:affricate:−voice +spread glottis	\t{\textsubbar{k}\textsubbar{x}} extsuperscript{h}
kx̠ʰː	k̠͡x̠ʰː	velar:affricate:−voice +spread glottis	\t{\textsubbar{k}\textsubbar{x}} extsuperscript{h}\textlengthmark
kx̠ʲ	k̠͡x̠ʲ	velar, palatal:affricate:−voice	\t{\textsubbar{k}\textsubbar{x}}\super j
kx̠ʲː	k̠͡x̠ʲː	velar, palatal:affricate:−voice	\t{\textsubbar{k}\textsubbar{x}}\super j\textlengthmark
kx̠ʷ	k̠͡x̠ʷ	velar, labial:affricate:−voice	\t{\textsubbar{k}\textsubbar{x}}\super w
kx̠ʷː	k̠͡x̠ʷː	velar, labial:affricate:−voice	\t{\textsubbar{k}\textsubbar{x}}\super w\textlengthmark
kx̠ː	k̠͡x̠ː	velar:affricate:−voice	\t{\textsubbar{k}\textsubbar{x}}\textlengthmark
kʰ	kʰ	velar:plosive:−voice +spread glottis	k extsuperscript{h}
kʰː	kʰː	velar:plosive:−voice +spread glottis	k extsuperscript{h}\textlengthmark
kʲ	kʲ	velar, palatal:plosive:−voice	k\super j
kʲʰ	kʰʲ	velar, palatal:plosive:−voice +spread glottis	k extsuperscript{h}\super j
kʲʰː	kʰʲː	velar, palatal:plosive:−voice +spread glottis	k extsuperscript{h}\super j\textlengthmark
kʲː	kʲː	velar, palatal:plosive:−voice	k\super j\textlengthmark
kʷ	kʷ	velar, labial:plosive:−voice	k\super w
kʷʰ	kʰʷ	velar, labial:plosive:−voice +spread glottis	k extsuperscript{h}\super w
kʷʰː	kʰʷː	velar, labial:plosive:−voice +spread glottis	k extsuperscript{h}\super w\textlengthmark
kʷː	kʷː	velar, labial:plosive:−voice	k\super w\textlengthmark
kː	kː	velar:plosive:−voice	k\textlengthmark
k̟	k̟	velar:plosive:−voice	\begin{IPA}\|+k̟\end{IPA}
k̟ʰ	k̟ʰ	velar:plosive:−voice +spread glottis	\begin{IPA}\|+k̟\end{IPA} extsuperscript{h}
k̟ʰː	k̟ʰː	velar:plosive:−voice +spread glottis	\begin{IPA}\|+k̟\end{IPA} extsuperscript{h}\textlengthmark
k̟ʲ	k̟ʲ	velar, palatal:plosive:−voice	\begin{IPA}\|+k̟\end{IPA}\super j
k̟ʲː	k̟ʲː	velar, palatal:plosive:−voice	\begin{IPA}\|+k̟\end{IPA}\super j\textlengthmark
k̟ʷ	k̟ʷ	velar, labial:plosive:−voice	\begin{IPA}\|+k̟\end{IPA}\super w
k̟ʷː	k̟ʷː	velar, labial:plosive:−voice	\begin{IPA}\|+k̟\end{IPA}\super w\textlengthmark
k̟ː	k̟ː	velar:plosive:−voice	\begin{IPA}\|+k̟\end{IPA}\textlengthmark
k̠	k̠	velar:plosive:−voice	\textsubbar{k}
k̠ʰ	k̠ʰ	velar:plosive:−voice +spread glottis	\textsubbar{k} extsuperscript{h}
k̠ʰː	k̠ʰː	velar:plosive:−voice +spread glottis	\textsubbar{k} extsuperscript{h}\textlengthmark
k̠ʲ	k̠ʲ	velar, palatal:plosive:−voice	\textsubbar{k}\super j
k̠ʲː	k̠ʲː	velar, palatal:plosive:−voice	\textsubbar{k}\super j\textlengthmark
k̠ʷ	k̠ʷ	velar, labial:plosive:−voice	\textsubbar{k}\super w
k̠ʷː	k̠ʷː	velar, labial:plosive:−voice	\textsubbar{k}\super w\textlengthmark
k̠ː	k̠ː	velar:plosive:−voice	\textsubbar{k}\textlengthmark
k̩	k̩	velar:plosive:−voice +syllabic	\textipa{\s{k}}
k̩ʲ	k̩ʲ	velar, palatal:plosive:−voice +syllabic	\textipa{\s{k}}\super j
k̩ʲː	k̩ʲː	velar, palatal:plosive:−voice +syllabic	\textipa{\s{k}}\super j\textlengthmark
k̩ʷ	k̩ʷ	velar, labial:plosive:−voice +syllabic	\textipa{\s{k}}\super w
k̩ʷː	k̩ʷː	velar, labial:plosive:−voice +syllabic	\textipa{\s{k}}\super w\textlengthmark
k̩ː	k̩ː	velar:plosive:−voice +syllabic	\textipa{\s{k}}\textlengthmark
l	l	alveolar:liquid:+voice +lateral	l
lʲ	lʲ	alveolar, palatal:liquid:+voice +lateral	l\super j
lʲˠ	ɫʲ	alveolar, palatal:liquid:+voice +lateral	\textltilde\super j
lˠ	ɫ	alveolar:liquid:+voice +lateral	\textltilde
l̠	l̠	alveolar:liquid:+voice +lateral	\textsubbar{l}
l̠ʲ	l̠ʲ	alveolar, palatal:liquid:+voice +lateral	\textsubbar{l}\super j
l̥	l̥	alveolar:liquid:−voice +lateral	*l
l̥ʲ	l̥ʲ	alveolar, palatal:liquid:−voice +lateral	*l\super j
l̥ʲˠ	ɫ̥ʲ	alveolar, palatal:liquid:−voice +lateral	*\textltilde\super j
l̥ˠ	ɫ̥	alveolar:liquid:−voice +lateral	*\textltilde
l̩	l̩	alveolar:liquid:+voice +lateral +syllabic	\textsyllabic{l}
l̩ˠ	ɫ̩	alveolar:liquid:+voice +lateral +syllabic	\textsyllabic{\textltilde}
l̩̥	l̥̩	alveolar:liquid:−voice +lateral +syllabic	\textipa{\s{ *l}}
l̩̥ˠ	ɫ̥̩	alveolar:liquid:−voice +lateral +syllabic	\textipa{\s{ *\textltilde}}
l̪	l̪	dental:liquid:+voice +lateral	\textsubbridge{l}
l̪ʲ	l̪ʲ	dental, palatal:liquid:+voice +lateral	\textsubbridge{l}\super j
m	m	labial:nasal:+voice +nasal	m
mʰ	mʰ	labial:nasal:+voice +nasal +spread glottis	m extsuperscript{h}
mʰː	mʰː	labial:nasal:+voice +nasal +spread glottis	m extsuperscript{h}\textlengthmark
mʲ	mʲ	labial, palatal:nasal:+voice +nasal	m\super j
mʲʰ	mʰʲ	labial, palatal:nasal:+voice +nasal +spread glottis	m extsuperscript{h}\super j
mʲʰː	mʰʲː	labial, palatal:nasal:+voice +nasal +spread glottis	m extsuperscript{h}\super j\textlengthmark
mʲː	mʲː	labial, palatal:nasal:+voice +nasal	m\super j\textlengthmark
mʷ	mʷ	labial:nasal:+voice +nasal	m\super w
mʷʰ	mʰʷ	labial:nasal:+voice +nasal +spread glottis	m extsuperscript{h}\super w
mʷʰː	mʰʷː	labial:nasal:+voice +nasal +spread glottis	m extsuperscript{h}\super w\textlengthmark
mʷː	mʷː	labial:nasal:+voice +nasal	m\super w\textlengthmark
mː	mː	labial:nasal:+voice +nasal	m\textlengthmark
m̥	m̥	labial:nasal:−voice +nasal	*m
m̥ʰ	m̥ʰ	labial:nasal:−voice +nasal +spread glottis	*m extsuperscript{h}
m̥ʰː	m̥ʰː	labial:nasal:−voice +nasal +spread glottis	*m extsuperscript{h}\textlengthmark
m̥ʲ	m̥ʲ	labial, palatal:nasal:−voice +nasal	*m\super j
m̥ʲʰ	m̥ʰʲ	labial, palatal:nasal:−voice +nasal +spread glottis	*m extsuperscript{h}\super j
m̥ʲʰː	m̥ʰʲː	labial, palatal:nasal:−voice +nasal +spread glottis	*m extsuperscript{h}\super j\textlengthmark
m̥ʲː	m̥ʲː	labial, palatal:nasal:−voice +nasal	*m\super j\textlengthmark
m̥ʷ	m̥ʷ	labial:nasal:−voice +nasal	*m\super w
m̥ʷʰ	m̥ʰʷ	labial:nasal:−voice +nasal +spread glottis	*m extsuperscript{h}\super w
m̥ʷʰː	m̥ʰʷː	labial:nasal:−voice +nasal +spread glottis	*m extsuperscript{h}\super w\textlengthmark
m̥ʷː	m̥ʷː	labial:nasal:−voice +nasal	*m\super w\textlengthmark
m̥ː	m̥ː	labial:nasal:−voice +nasal	*m\textlengthmark
m̩	m̩	labial:nasal:+voice +nasal +syllabic	\textsyllabic{m}
m̩ʲ	m̩ʲ	labial, palatal:nasal:+voice +nasal +syllabic	\textsyllabic{m}\super j
m̩ʲː	m̩ʲː	labial, palatal:nasal:+voice +nasal +syllabic	\textsyllabic{m}\super j\textlengthmark
m̩ʷ	m̩ʷ	labial:nasal:+voice +nasal +syllabic	\textsyllabic{m}\super w
m̩ʷː	m̩ʷː	labial:nasal:+voice +nasal +syllabic	\textsyllabic{m}\super w\textlengthmark
m̩ː	m̩ː	labial:nasal:+voice +nasal +syllabic	\textsyllabic{m}\textlengthmark
m̩̥	m̥̩	labial:nasal:−voice +nasal +syllabic	\textipa{\s{ *m}}
m̩̥ʲ	m̥̩ʲ	labial, palatal:nasal:−voice +nasal +syllabic	\textipa{\s{ *m}}\super j
m̩̥ʲː	m̥̩ʲː	labial, palatal:nasal:−voice +nasal +syllabic	\textipa{\s{ *m}}\super j\textlengthmark
m̩̥ʷ	m̥̩ʷ	labial:nasal:−voice +nasal +syllabic	\textipa{\s{ *m}}\super w
m̩̥ʷː	m̥̩ʷː	labial:nasal:−voice +nasal +syllabic	\textipa{\s{ *m}}\super w\textlengthmark
m̩̥ː	m̥̩ː	labial:nasal:−voice +nasal +syllabic	\textipa{\s{ *m}}\textlengthmark
n	n	alveolar:nasal:+voice +nasal	n
nʰ	nʰ	alveolar:nasal:+voice +nasal +spread glottis	n extsuperscript{h}
nʰː	nʰː	alveolar:nasal:+voice +nasal +spread glottis	n extsuperscript{h}\textlengthmark
nʲ	nʲ	alveolar, palatal:nasal:+voice +nasal	n\super j
nʲʰ	nʰʲ	alveolar, palatal:nasal:+voice +nasal +spread glottis	n extsuperscript{h}\super j
nʲʰː	nʰʲː	alveolar, palatal:nasal:+voice +nasal +spread glottis	n extsuperscript{h}\super j\textlengthmark
nʲː	nʲː	alveolar, palatal:nasal:+voice +nasal	n\super j\textlengthmark
nʷ	nʷ	alveolar, labial:nasal:+voice +nasal	n\super w
nʷʰ	nʰʷ	alveolar, labial:nasal:+voice +nasal +spread glottis	n extsuperscript{h}\super w
nʷʰː	nʰʷː	alveolar, labial:nasal:+voice +nasal +spread glottis	n extsuperscript{h}\super w\textlengthmark
nʷː	nʷː	alveolar, labial:nasal:+voice +nasal	n\super w\textlengthmark
nː	nː	alveolar:nasal:+voice +nasal	n\textlengthmark
n̠	n̠	alveolar:nasal:+voice +nasal	\textipa{\=*n}
n̠ʰ	n̠ʰ	alveolar:nasal:+voice +nasal +spread glottis	\textipa{\=*n} extsuperscript{h}
n̠ʰː	n̠ʰː	alveolar:nasal:+voice +nasal +spread glottis	\textipa{\=*n} extsuperscript{h}\textlengthmark
n̠ʲ	n̠ʲ	alveolar, palatal:nasal:+voice +nasal	\textipa{\=*n}\super j
n̠ʲː	n̠ʲː	alveolar, palatal:nasal:+voice +nasal	\textipa{\=*n}\super j\textlengthmark
n̠ʷ	n̠ʷ	alveolar, labial:nasal:+voice +nasal	\textipa{\=*n}\super w
n̠ʷː	n̠ʷː	alveolar, labial:nasal:+voice +nasal	\textipa{\=*n}\super w\textlengthmark
n̠ː	n̠ː	alveolar:nasal:+voice +nasal	\textipa{\=*n}\textlengthmark
n̥	n̥	alveolar:nasal:−voice +nasal	*n
n̥ʰ	n̥ʰ	alveolar:nasal:−voice +nasal +spread glottis	*n extsuperscript{h}
n̥ʰː	n̥ʰː	alveolar:nasal:−voice +nasal +spread glottis	*n extsuperscript{h}\textlengthmark
n̥ʲ	n̥ʲ	alveolar, palatal:nasal:−voice +nasal	*n\super j
n̥ʲʰ	n̥ʰʲ	alveolar, palatal:nasal:−voice +nasal +spread glottis	*n extsuperscript{h}\super j
n̥ʲʰː	n̥ʰʲː	alveolar, palatal:nasal:−voice +nasal +spread glottis	*n extsuperscript{h}\super j\textlengthmark
n̥ʲː	n̥ʲː	alveolar, palatal:nasal:−voice +nasal	*n\super j\textlengthmark
n̥ʷ	n̥ʷ	alveolar, labial:nasal:−voice +nasal	*n\super w
n̥ʷʰ	n̥ʰʷ	alveolar, labial:nasal:−voice +nasal +spread glottis	*n extsuperscript{h}\super w
n̥ʷʰː	n̥ʰʷː	alveolar, labial:nasal:−voice +nasal +spread glottis	*n extsuperscript{h}\super w\textlengthmark
n̥ʷː	n̥ʷː	alveolar, labial:nasal:−voice +nasal	*n\super w\textlengthmark
n̥ː	n̥ː	alveolar:nasal:−voice +nasal	*n\textlengthmark
n̩	n̩	alveolar:nasal:+voice +nasal +syllabic	\textsyllabic{n}
n̩ʲ	n̩ʲ	alveolar, palatal:nasal:+voice +nasal +syllabic	\textsyllabic{n}\super j
n̩ʲː	n̩ʲː	alveolar, palatal:nasal:+voice +nasal +syllabic	\textsyllabic{n}\super j\textlengthmark
n̩ʷ	n̩ʷ	alveolar, labial:nasal:+voice +nasal +syllabic	\textsyllabic{n}\super w
n̩ʷː	n̩ʷː	alveolar, labial:nasal:+voice +nasal +syllabic	\textsyllabic{n}\super w\textlengthmark
n̩ː	n̩ː	alveolar:nasal:+voice +nasal +syllabic	\textsyllabic{n}\textlengthmark
n̩̥	n̥̩	alveolar:nasal:−voice +nasal +syllabic	\textipa{\s{ *n}}
n̩̥ʲ	n̥̩ʲ	alveolar, palatal:nasal:−voice +nasal +syllabic	\textipa{\s{ *n}}\super j
n̩̥ʲː	n̥̩ʲː	alveolar, palatal:nasal:−voice +nasal +syllabic	\textipa{\s{ *n}}\super j\textlengthmark
n̩̥ʷ	n̥̩ʷ	alveolar, labial:nasal:−voice +nasal +syllabic	\textipa{\s{ *n}}\super w
n̩̥ʷː	n̥̩ʷː	alveolar, labial:nasal:−voice +nasal +syllabic	\textipa{\s{ *n}}\super w\textlengthmark
n̩̥ː	n̥̩ː	alveolar:nasal:−voice +nasal +syllabic	\textipa{\s{ *n}}\textlengthmark
n̪	n̪	dental:nasal:+voice +nasal	\textsubbridge{n}
n̪ʰ	n̪ʰ	dental:nasal:+voice +nasal +spread glottis	\textsubbridge{n} extsuperscript{h}
n̪ʰː	n̪ʰː	dental:nasal:+voice +nasal +spread glottis	\textsubbridge{n} extsuperscript{h}\textlengthmark
n̪ʲ	n̪ʲ	dental, palatal:nasal:+voice +nasal	\textsubbridge{n}\super j
n̪ʲː	n̪ʲː	dental, palatal:nasal:+voice +nasal	\textsubbridge{n}\super j\textlengthmark
n̪ʷ	n̪ʷ	dental, labial:nasal:+voice +nasal	\textsubbridge{n}\super w
n̪ʷː	n̪ʷː	dental, labial:nasal:+voice +nasal	\textsubbridge{n}\super w\textlengthmark
n̪ː	n̪ː	dental:nasal:+voice +nasal	\textsubbridge{n}\textlengthmark
o	o	empty:vowel:−high −low +back +round +voice −nasal −spread glottis −constricted glottis	o
oː	oː	empty:vowel:−high −low +back +round +voice −nasal −spread glottis −constricted glottis	o\textlengthmark
õ	õ	empty:vowel:−high −low +back +round +voice +nasal −spread glottis −constricted glottis	\textipa{\~o}
õː	õː	empty:vowel:−high −low +back +round +voice +nasal −spread glottis −constricted glottis	\textipa{\~o}\textlengthmark
o̥	o̥	empty:vowel:−high −low +back +round −voice −nasal −spread glottis −constricted glottis	*o
o̥ː	o̥ː	empty:vowel:−high −low +back +round −voice −nasal −spread glottis −constricted glottis	*o\textlengthmark
õ̥	õ̥	empty:vowel:−high −low +back +round −voice +nasal −spread glottis −constricted glottis	*\textipa{\~o}
õ̥ː	õ̥ː	empty:vowel:−high −low +back +round −voice +nasal −spread glottis −constricted glottis	*\textipa{\~o}\textlengthmark
o̥̯	o̯̥	empty:vowel:−high −low +back +round −voice −nasal −spread glottis −constricted glottis	*\textroundcap{o}
o̥̯ː	o̯̥ː	empty:vowel:−high −low +back +round −voice −nasal −spread glottis −constricted glottis	*\textroundcap{o}\textlengthmark
õ̥̯	õ̯̥	empty:vowel:−high −low +back +round −voice +nasal −spread glottis −constricted glottis	*\textipa{\~\textroundcap{o}}
õ̥̯ː	õ̯̥ː	empty:vowel:−high −low +back +round −voice +nasal −spread glottis −constricted glottis	*\textipa{\~\textroundcap{o}}\textlengthmark
o̯	o̯	empty:vowel:−high −low +back +round +voice −nasal −spread glottis −constricted glottis	\textroundcap{o}
o̯ː	o̯ː	empty:vowel:−high −low +back +round +voice −nasal −spread glottis −constricted glottis	\textroundcap{o}\textlengthmark
õ̯	õ̯	empty:vowel:−high −low +back +round +voice +nasal −spread glottis −constricted glottis	\textipa{\~\textroundcap{o}}
õ̯ː	õ̯ː	empty:vowel:−high −low +back +round +voice +nasal −spread glottis −constricted glottis	\textipa{\~\textroundcap{o}}\textlengthmark
p	p	labial:plosive:−voice	p
pf	p͡f	labiodental:affricate:−voice	\t{pf}
pfʰ	p͡fʰ	labiodental:affricate:−voice +spread glottis	\t{pf} extsuperscript{h}
pfʰː	p͡fʰː	labiodental:affricate:−voice +spread glottis	\t{pf} extsuperscript{h}\textlengthmark
pfʲ	p͡fʲ	labiodental, palatal:affricate:−voice	\t{pf}\super j
pfʲː	p͡fʲː	labiodental, palatal:affricate:−voice	\t{pf}\super j\textlengthmark
pfʷ	p͡fʷ	labiodental, labial:affricate:−voice	\t{pf}\super w
pfʷː	p͡fʷː	labiodental, labial:affricate:−voice	\t{pf}\super w\textlengthmark
pfː	p͡fː	labiodental:affricate:−voice	\t{pf}\textlengthmark
pt	p͡t	labial, alveolar:plosive:−voice	\t{p͡t}
ptʰ	p͡tʰ	labial, alveolar:plosive:−voice +spread glottis	\t{p͡t} extsuperscript{h}
ptʰː	p͡tʰː	labial, alveolar:plosive:−voice +spread glottis	\t{p͡t} extsuperscript{h}\textlengthmark
ptʲ	p͡tʲ	labial, alveolar, palatal:plosive:−voice	\t{p͡t}\super j
ptʲː	p͡tʲː	labial, alveolar, palatal:plosive:−voice	\t{p͡t}\super j\textlengthmark
ptʷ	p͡tʷ	labial, alveolar:plosive:−voice	\t{p͡t}\super w
ptʷː	p͡tʷː	labial, alveolar:plosive:−voice	\t{p͡t}\super w\textlengthmark
ptː	p͡tː	labial, alveolar:plosive:−voice	\t{p͡t}\textlengthmark
pɸ	p͡ɸ	labial:affricate:−voice	\t{p͡\textipa{F}}
pɸʰ	p͡ɸʰ	labial:affricate:−voice +spread glottis	\t{p͡\textipa{F}} extsuperscript{h}
pɸʰː	p͡ɸʰː	labial:affricate:−voice +spread glottis	\t{p͡\textipa{F}} extsuperscript{h}\textlengthmark
pɸʲ	p͡ɸʲ	labial, palatal:affricate:−voice	\t{p͡\textipa{F}}\super j
pɸʲː	p͡ɸʲː	labial, palatal:affricate:−voice	\t{p͡\textipa{F}}\super j\textlengthmark
pɸʷ	p͡ɸʷ	labial:affricate:−voice	\t{p͡\textipa{F}}\super w
pɸʷː	p͡ɸʷː	labial:affricate:−voice	\t{p͡\textipa{F}}\super w\textlengthmark
pɸː	p͡ɸː	labial:affricate:−voice	\t{p͡\textipa{F}}\textlengthmark
pʰ	pʰ	labial:plosive:−voice +spread glottis	p extsuperscript{h}
pʰʲ	pʰʲ	labial, palatal:plosive:−voice +spread glottis	p extsuperscript{h}\super j
pʰː	pʰː	labial:plosive:−voice +spread glottis	p extsuperscript{h}\textlengthmark
pʲ	pʲ	labial, palatal:plosive:−voice	p\super j
pʲʰː	pʰʲː	labial, palatal:plosive:−voice +spread glottis	p extsuperscript{h}\super j\textlengthmark
pʲː	pʲː	labial, palatal:plosive:−voice	p\super j\textlengthmark
pʷ	pʷ	labial:plosive:−voice	p\super w
pʷʰ	pʰʷ	labial:plosive:−voice +spread glottis	p extsuperscript{h}\super w
pʷʰː	pʰʷː	labial:plosive:−voice +spread glottis	p extsuperscript{h}\super w\textlengthmark
pʷː	pʷː	labial:plosive:−voice	p\super w\textlengthmark
pː	pː	labial:plosive:−voice	p\textlengthmark
p̩	p̩	labial:plosive:−voice +syllabic	\textipa{\s{p}}
p̩ʲ	p̩ʲ	labial, palatal:plosive:−voice +syllabic	\textipa{\s{p}}\super j
p̩ʲː	p̩ʲː	labial, palatal:plosive:−voice +syllabic	\textipa{\s{p}}\super j\textlengthmark
p̩ʷ	p̩ʷ	labial:plosive:−voice +syllabic	\textipa{\s{p}}\super w
p̩ʷː	p̩ʷː	labial:plosive:−voice +syllabic	\textipa{\s{p}}\super w\textlengthmark
p̩ː	p̩ː	labial:plosive:−voice +syllabic	\textipa{\s{p}}\textlengthmark
q	q	uvular:plosive:−voice	q
qʰ	qʰ	uvular:plosive:−voice +spread glottis	q extsuperscript{h}
qʰː	qʰː	uvular:plosive:−voice +spread glottis	q extsuperscript{h}\textlengthmark
qʲ	qʲ	uvular, palatal:plosive:−voice	q\super j
qʲʰ	qʰʲ	uvular, palatal:plosive:−voice +spread glottis	q extsuperscript{h}\super j
qʲʰː	qʰʲː	uvular, palatal:plosive:−voice +spread glottis	q extsuperscript{h}\super j\textlengthmark
qʲː	qʲː	uvular, palatal:plosive:−voice	q\super j\textlengthmark
qʷ	qʷ	uvular, labial:plosive:−voice	q\super w
qʷʰ	qʰʷ	uvular, labial:plosive:−voice +spread glottis	q extsuperscript{h}\super w
qʷʰː	qʰʷː	uvular, labial:plosive:−voice +spread glottis	q extsuperscript{h}\super w\textlengthmark
qʷː	qʷː	uvular, labial:plosive:−voice	q\super w\textlengthmark
qː	qː	uvular:plosive:−voice	q\textlengthmark
q̩	q̩	uvular:plosive:−voice +syllabic	\textipa{\s{q}}
q̩ʲ	q̩ʲ	uvular, palatal:plosive:−voice +syllabic	\textipa{\s{q}}\super j
q̩ʲː	q̩ʲː	uvular, palatal:plosive:−voice +syllabic	\textipa{\s{q}}\super j\textlengthmark
q̩ʷ	q̩ʷ	uvular, labial:plosive:−voice +syllabic	\textipa{\s{q}}\super w
q̩ʷː	q̩ʷː	uvular, labial:plosive:−voice +syllabic	\textipa{\s{q}}\super w\textlengthmark
q̩ː	q̩ː	uvular:plosive:−voice +syllabic	\textipa{\s{q}}\textlengthmark
qχ	q͡χ	uvular:affricate:−voice	\t{q͡\textchi}
qχʰ	q͡χʰ	uvular:affricate:−voice +spread glottis	\t{q͡\textchi} extsuperscript{h}
qχʰː	q͡χʰː	uvular:affricate:−voice +spread glottis	\t{q͡\textchi} extsuperscript{h}\textlengthmark
qχʲ	q͡χʲ	uvular, palatal:affricate:−voice	\t{q͡\textchi}\super j
qχʲː	q͡χʲː	uvular, palatal:affricate:−voice	\t{q͡\textchi}\super j\textlengthmark 
qχʷ	q͡χʷ	uvular, labial:affricate:−voice	\t{q͡\textchi}\super w
qχʷː	q͡χʷː	uvular, labial:affricate:−voice	\t{q͡\textchi}\super w\textlengthmark
qχː	q͡χː	uvular:affricate:−voice	\t{q͡\textchi}\textlengthmark
r	r	alveolar:liquid:+voice −lateral	r
rʲ	rʲ	alveolar, palatal:liquid:+voice −lateral	r\super j
r̠	r̠	alveolar:liquid:+voice −lateral	\textsubbar{r}
r̠ʲ	r̠ʲ	alveolar, palatal:liquid:+voice −lateral	\textsubbar{r}\super j
r̥	r̥	alveolar:liquid:−voice −lateral	*r
r̥ʲ	r̥ʲ	alveolar, palatal:liquid:−voice −lateral	*r\super j
r̩	r̩	alveolar:liquid:+voice −lateral +syllabic	\textipa{\s{r}}
r̩̥	r̥̩	alveolar:liquid:−voice −lateral +syllabic	\textipa{\s{ *r}}
r̪	r̪	dental:liquid:+voice −lateral	\textsubbridge{r}
r̪ʲ	r̪ʲ	dental, palatal:liquid:+voice −lateral	\textsubbridge{r}\super j
s	s	alveolar:fricative:−voice	s
sʲ	sʲ	alveolar, palatal:fricative:−voice	s\super j
sʲː	sʲː	alveolar, palatal:fricative:−voice	s\super j\textlengthmark
sʷ	sʷ	alveolar, labial:fricative:−voice	s\super w
sʷː	sʷː	alveolar, labial:fricative:−voice	s\super w\textlengthmark
sː	sː	alveolar:fricative:−voice	s\textlengthmark
s̩	s̩	alveolar:fricative:−voice +syllabic	\textipa{\s{s}}
s̩ʲ	s̩ʲ	alveolar, palatal:fricative:−voice +syllabic	\textipa{\s{s}}\super j
s̩ʲː	s̩ʲː	alveolar, palatal:fricative:−voice +syllabic	\textipa{\s{s}}\super j\textlengthmark
s̩ʷ	s̩ʷ	alveolar, labial:fricative:−voice +syllabic	\textipa{\s{s}}\super w
s̩ʷː	s̩ʷː	alveolar, labial:fricative:−voice +syllabic	\textipa{\s{s}}\super w\textlengthmark
s̩ː	s̩ː	alveolar:fricative:−voice +syllabic	\textipa{\s{s}}\textlengthmark
t	t	alveolar:plosive:−voice	t
ts	t͡s	alveolar:affricate:−voice	\t{ts}
tsʰ	t͡sʰ	alveolar:affricate:−voice +spread glottis	\t{ts} extsuperscript{h}
tsʰː	t͡sʰː	alveolar:affricate:−voice +spread glottis	\t{ts} extsuperscript{h}\textlengthmark
tsʲ	t͡sʲ	alveolar, palatal:affricate:−voice	\t{ts}\super j
tsʲː	t͡sʲː	alveolar, palatal:affricate:−voice	\t{ts}\super j\textlengthmark
tsʷ	t͡sʷ	alveolar, labial:affricate:−voice	\t{ts}\super w
tsʷː	t͡sʷː	alveolar, labial:affricate:−voice	\t{ts}\super w\textlengthmark
tsː	t͡sː	alveolar:affricate:−voice	\t{ts}\textlengthmark
ts̪	t̪͡s̪	dental:affricate:−voice	\t{\textsubbridge{t}\textsubbridge{s}}
ts̪ʰ	t̪͡s̪ʰ	dental:affricate:−voice +spread glottis	\t{\textsubbridge{t}\textsubbridge{s}} extsuperscript{h}
ts̪ʰː	t̪͡s̪ʰː	dental:affricate:−voice +spread glottis	\t{\textsubbridge{t}\textsubbridge{s}} extsuperscript{h}\textlengthmark
ts̪ʲ	t̪͡s̪ʲ	dental, palatal:affricate:−voice	\t{\textsubbridge{t}\textsubbridge{s}}\super j
ts̪ʲː	t̪͡s̪ʲː	dental, palatal:affricate:−voice	\t{\textsubbridge{t}\textsubbridge{s}}\super j\textlengthmark
ts̪ʷ	t̪͡s̪ʷ	dental, labial:affricate:−voice	\t{\textsubbridge{t}\textsubbridge{s}}\super w
ts̪ʷː	t̪͡s̪ʷː	dental, labial:affricate:−voice	\t{\textsubbridge{t}\textsubbridge{s}}\super w\textlengthmark
ts̪ː	t̪͡s̪ː	dental:affricate:−voice	\t{\textsubbridge{t}\textsubbridge{s}}\textlengthmark
tɕ	t͡ɕ	alveolar, palatal:affricate:−voice	\t{t͡\textctc}
tɕʰ	t͡ɕʰ	alveolar, palatal:affricate:−voice +spread glottis	\t{t͡\textctc} extsuperscript{h}
tɕʰː	t͡ɕʰː	alveolar, palatal:affricate:−voice +spread glottis	\t{t͡\textctc} extsuperscript{h}\textlengthmark
tɕʲ	t͡ɕʲ	alveolar, palatal:affricate:−voice	\t{t͡\textctc}\super j
tɕʲː	t͡ɕʲː	alveolar, palatal:affricate:−voice	\t{t͡\textctc}\super j\textlengthmark
tɕʷ	t͡ɕʷ	alveolar, palatal, labial:affricate:−voice	\t{t͡\textctc}\super w
tɕʷː	t͡ɕʷː	alveolar, palatal, labial:affricate:−voice	\t{t͡\textctc}\super w\textlengthmark
tɕː	t͡ɕː	alveolar, palatal:affricate:−voice	\t{t͡\textctc}\textlengthmark
tɬ	t͡ɬ	alveolar:affricate:+voice +lateral	\t{t͡\textbeltl}
tɬʰ	t͡ɬʰ	alveolar:affricate:+voice +lateral +spread glottis	\t{t͡\textbeltl} extsuperscript{h}
tɬʰː	t͡ɬʰː	alveolar:affricate:+voice +lateral +spread glottis	\t{t͡\textbeltl} extsuperscript{h}\textlengthmark
tɬʲ	t͡ɬʲ	alveolar, palatal:affricate:+voice +lateral	\t{t͡\textbeltl}\super j
tɬʲː	t͡ɬʲː	alveolar, palatal:affricate:+voice +lateral	\t{t͡\textbeltl}\super j\textlengthmark
tɬʷ	t͡ɬʷ	alveolar, labial:affricate:+voice +lateral	\t{t͡\textbeltl}\super w
tɬʷː	t͡ɬʷː	alveolar, labial:affricate:+voice +lateral	\t{t͡\textbeltl}\super w\textlengthmark
tɬː	t͡ɬː	alveolar:affricate:+voice +lateral	\t{t͡\textbeltl}\textlengthmark
tɬ̪	t̪͡ɬ̪	dental:affricate:+voice +lateral	\t{\textsubbridge{t}͡\textsubbridge{\textbeltl}}
tɬ̪ʰ	t̪͡ɬ̪ʰ	dental:affricate:+voice +lateral +spread glottis	\t{\textsubbridge{t}͡\textsubbridge{\textbeltl}} extsuperscript{h}
tɬ̪ʰː	t̪͡ɬ̪ʰː	dental:affricate:+voice +lateral +spread glottis	\t{\textsubbridge{t}͡\textsubbridge{\textbeltl}} extsuperscript{h}\textlengthmark
tɬ̪ʲ	t̪͡ɬ̪ʲ	dental, palatal:affricate:+voice +lateral	\t{\textsubbridge{t}͡\textsubbridge{\textbeltl}}\super j
tɬ̪ʲː	t̪͡ɬ̪ʲː	dental, palatal:affricate:+voice +lateral	\t{\textsubbridge{t}͡\textsubbridge{\textbeltl}}\super j\textlengthmark
tɬ̪ʷ	t̪͡ɬ̪ʷ	dental, labial:affricate:+voice +lateral	\t{\textsubbridge{t}͡\textsubbridge{\textbeltl}}\super w
tɬ̪ʷː	t̪͡ɬ̪ʷː	dental, labial:affricate:+voice +lateral	\t{\textsubbridge{t}͡\textsubbridge{\textbeltl}}\super w\textlengthmark
tɬ̪ː	t̪͡ɬ̪ː	dental:affricate:+voice +lateral	\t{\textsubbridge{t}͡\textsubbridge{\textbeltl}}\textlengthmark
tʃ	t͡ʃ	palatoalveolar:affricate:−voice	\t{t͡\textipa{S}}
tʃʰ	t͡ʃʰ	palatoalveolar:affricate:−voice +spread glottis	\t{t͡\textipa{S}} extsuperscript{h}
tʃʰː	t͡ʃʰː	palatoalveolar:affricate:−voice +spread glottis	\t{t͡\textipa{S}} extsuperscript{h}\textlengthmark
tʃʲ	t͡ʃʲ	palatoalveolar, palatal:affricate:−voice	\t{t͡\textipa{S}}\super j
tʃʲː	t͡ʃʲː	palatoalveolar, palatal:affricate:−voice	\t{t͡\textipa{S}}\super j\textlengthmark
tʃʷ	t͡ʃʷ	palatoalveolar, labial:affricate:−voice	\t{t͡\textipa{S}}\super w
tʃʷː	t͡ʃʷː	palatoalveolar, labial:affricate:−voice	\t{t͡\textipa{S}}\super w\textlengthmark
tʃː	t͡ʃː	palatoalveolar:affricate:−voice	\t{t͡\textipa{S}}\textlengthmark
tʰ	tʰ	alveolar:plosive:−voice +spread glottis	t extsuperscript{h}
tʰː	tʰː	alveolar:plosive:−voice +spread glottis	t extsuperscript{h}\textlengthmark
tʲ	tʲ	alveolar, palatal:plosive:−voice	t\super j
tʲʰ	tʰʲ	alveolar, palatal:plosive:−voice +spread glottis	t extsuperscript{h}\super j
tʲʰː	tʰʲː	alveolar, palatal:plosive:−voice +spread glottis	t extsuperscript{h}\super j\textlengthmark
tʲː	tʲː	alveolar, palatal:plosive:−voice	t\super j\textlengthmark
tʷ	tʷ	alveolar, labial:plosive:−voice	t\super w
tʷʰ	tʰʷ	alveolar, labial:plosive:−voice +spread glottis	t extsuperscript{h}\super w
tʷʰː	tʰʷː	alveolar, labial:plosive:−voice +spread glottis	t extsuperscript{h}\super w\textlengthmark
tʷː	tʷː	alveolar, labial:plosive:−voice	t\super w\textlengthmark
tː	tː	alveolar:plosive:−voice	t\textlengthmark
t̠	t̠	alveolar:plosive:−voice	\textsubbar{t}
t̠ʰ	t̠ʰ	alveolar:plosive:−voice +spread glottis	\textsubbar{t} extsuperscript{h}
t̠ʰː	t̠ʰː	alveolar:plosive:−voice +spread glottis	\textsubbar{t} extsuperscript{h}\textlengthmark
t̠ʲ	t̠ʲ	alveolar, palatal:plosive:−voice	\textsubbar{t}\super j
t̠ʲː	t̠ʲː	alveolar, palatal:plosive:−voice	\textsubbar{t}\super j\textlengthmark
t̠ʷ	t̠ʷ	alveolar, labial:plosive:−voice	\textsubbar{t}\super w
t̠ʷː	t̠ʷː	alveolar, labial:plosive:−voice	\textsubbar{t}\super w\textlengthmark
t̠ː	t̠ː	alveolar:plosive:−voice	\textsubbar{t}\textlengthmark
t̩	t̩	alveolar:plosive:−voice +syllabic	\textipa{\s{t}}
t̩ʲ	t̩ʲ	alveolar, palatal:plosive:−voice +syllabic	\textipa{\s{t}}\super j
t̩ʲː	t̩ʲː	alveolar, palatal:plosive:−voice +syllabic	\textipa{\s{t}}\super j\textlengthmark
t̩ʷ	t̩ʷ	alveolar, labial:plosive:−voice +syllabic	\textipa{\s{t}}\super w
t̩ʷː	t̩ʷː	alveolar, labial:plosive:−voice +syllabic	\textipa{\s{t}}\super w\textlengthmark
t̩ː	t̩ː	alveolar:plosive:−voice +syllabic	\textipa{\s{t}}\textlengthmark
t̪	t̪	dental:plosive:−voice	\textsubbridge{t}
t̪ʰ	t̪ʰ	dental:plosive:−voice +spread glottis	\textsubbridge{t} extsuperscript{h}
t̪ʰː	t̪ʰː	dental:plosive:−voice +spread glottis	\textsubbridge{t} extsuperscript{h}\textlengthmark
t̪ʲ	t̪ʲ	dental, palatal:plosive:−voice	\textsubbridge{t}\super j
t̪ʲː	t̪ʲː	dental, palatal:plosive:−voice	\textsubbridge{t}\super j\textlengthmark
t̪ʷ	t̪ʷ	dental, labial:plosive:−voice	\textsubbridge{t}\super w
t̪ʷː	t̪ʷː	dental, labial:plosive:−voice	\textsubbridge{t}\super w\textlengthmark
t̪ː	t̪ː	dental:plosive:−voice	\textsubbridge{t}\textlengthmark
tθ	t̪͡θ	dental:affricate:−voice	\t{\textsubbridge{t}͡ \textipa{T}}
tθʰ	t̪͡θʰ	dental:affricate:−voice +spread glottis	\t{\textsubbridge{t}͡ \textipa{T}} extsuperscript{h}
tθʰː	t̪͡θʰː	dental:affricate:−voice +spread glottis	\t{\textsubbridge{t}͡ \textipa{T}} extsuperscript{h}\textlengthmark
tθʲ	t̪͡θʲ	dental, palatal:affricate:−voice	\t{\textsubbridge{t}͡ \textipa{T}}\super j
tθʲː	t̪͡θʲː	dental, palatal:affricate:−voice	\t{\textsubbridge{t}͡ \textipa{T}}\super j\textlengthmark
tθʷ	t̪͡θʷ	dental, labial:affricate:−voice	\t{\textsubbridge{t}͡ \textipa{T}}\super w
tθʷː	t̪͡θʷː	dental, labial:affricate:−voice	\t{\textsubbridge{t}͡ \textipa{T}}\super w\textlengthmark
tθː	t̪͡θː	dental:affricate:−voice	\t{\textsubbridge{t}͡ \textipa{T}}\textlengthmark
u	u	empty:vowel:+high −low +back +round +voice −nasal −spread glottis −constricted glottis	u
uː	uː	empty:vowel:+high −low +back +round +voice −nasal −spread glottis −constricted glottis	u\textlengthmark
ũ	ũ	empty:vowel:+high −low +back +round +voice +nasal −spread glottis −constricted glottis	\textipa{\~u}
ũː	ũː	empty:vowel:+high −low +back +round +voice +nasal −spread glottis −constricted glottis	\textipa{\~u}\textlengthmark
u̥	u̥	empty:vowel:+high −low +back +round −voice −nasal −spread glottis −constricted glottis	*u
u̥ː	u̥ː	empty:vowel:+high −low +back +round −voice −nasal −spread glottis −constricted glottis	*u\textlengthmark
ũ̥	ũ̥	empty:vowel:+high −low +back +round −voice +nasal −spread glottis −constricted glottis	*\textipa{\~u}
ũ̥ː	ũ̥ː	empty:vowel:+high −low +back +round −voice +nasal −spread glottis −constricted glottis	*\textipa{\~u}\textlengthmark
u̥̯	u̯̥	empty:vowel:+high −low +back +round −voice −nasal −spread glottis −constricted glottis	*\textroundcap{u}
u̥̯ː	u̯̥ː	empty:vowel:+high −low +back +round −voice −nasal −spread glottis −constricted glottis	*\textroundcap{u}\textlengthmark
ũ̥̯	ũ̯̥	empty:vowel:+high −low +back +round −voice +nasal −spread glottis −constricted glottis	*\textipa{\~\textroundcap{u}}
ũ̥̯ː	ũ̯̥ː	empty:vowel:+high −low +back +round −voice +nasal −spread glottis −constricted glottis	*\textipa{\~\textroundcap{u}}\textlengthmark
u̯	u̯	empty:vowel:+high −low +back +round +voice −nasal −spread glottis −constricted glottis	\textroundcap{u}
u̯ː	u̯ː	empty:vowel:+high −low +back +round +voice −nasal −spread glottis −constricted glottis	\textroundcap{u}\textlengthmark
ũ̯	ũ̯	empty:vowel:+high −low +back +round +voice +nasal −spread glottis −constricted glottis	\textipa{\~\textroundcap{u}}
ũ̯ː	ũ̯ː	empty:vowel:+high −low +back +round +voice +nasal −spread glottis −constricted glottis	\textipa{\~\textroundcap{u}}\textlengthmark
v	v	labiodental:fricative:+voice	v
vʲ	vʲ	labiodental, palatal:fricative:+voice	v\super j
vʲː	vʲː	labiodental, palatal:fricative:+voice	v\super j\textlengthmark
vʷ	vʷ	labiodental, labial:fricative:+voice	v\super w
vʷː	vʷː	labiodental, labial:fricative:+voice	v\super w\textlengthmark
vː	vː	labiodental:fricative:+voice	v\textlengthmark
v̩	v̩	labiodental:fricative:+voice +syllabic	\textipa{\s{v}}
v̩ʲ	v̩ʲ	labiodental, palatal:fricative:+voice +syllabic	\textipa{\s{v}}\super j
v̩ʲː	v̩ʲː	labiodental, palatal:fricative:+voice +syllabic	\textipa{\s{v}}\super j\textlengthmark
v̩ʷ	v̩ʷ	labiodental, labial:fricative:+voice +syllabic	\textipa{\s{v}}\super w
v̩ʷː	v̩ʷː	labiodental, labial:fricative:+voice +syllabic	\textipa{\s{v}}\super w\textlengthmark
v̩ː	v̩ː	labiodental:fricative:+voice +syllabic	\textipa{\s{v}}\textlengthmark
w	w	labial, velar:glide:+voice	w
w̃	w̃	labial, velar:glide:+voice +nasal	\textipa{\~w}
x	x	velar:fricative:−voice	x
xʲ	xʲ	velar, palatal:fricative:−voice	x\super j
xʲː	xʲː	velar, palatal:fricative:−voice	x\super j\textlengthmark
xʷ	xʷ	velar, labial:fricative:−voice	x\super w
xʷː	xʷː	velar, labial:fricative:−voice	x\super w\textlengthmark
xː	xː	velar:fricative:−voice	x\textlengthmark
x̟	x̟	velar:fricative:−voice	\begin{IPA}\|+x̟\end{IPA}
x̟ʲ	x̟ʲ	velar, palatal:fricative:−voice	\begin{IPA}\|+x̟\end{IPA}\super j
x̟ʲː	x̟ʲː	velar, palatal:fricative:−voice	\begin{IPA}\|+x̟\end{IPA}\super j\textlengthmark
x̟ʷ	x̟ʷ	velar, labial:fricative:−voice	\begin{IPA}\|+x̟\end{IPA}\super w
x̟ʷː	x̟ʷː	velar, labial:fricative:−voice	\begin{IPA}\|+x̟\end{IPA}\super w\textlengthmark
x̟ː	x̟ː	velar:fricative:−voice	\begin{IPA}\|+x̟\end{IPA}\textlengthmark
x̠	x̠	velar:fricative:−voice	\textsubbar{x}
x̠ʲ	x̠ʲ	velar, palatal:fricative:−voice	\textsubbar{x}\super j
x̠ʲː	x̠ʲː	velar, palatal:fricative:−voice	\textsubbar{x}\super j\textlengthmark
x̠ʷ	x̠ʷ	velar, labial:fricative:−voice	\textsubbar{x}\super w
x̠ʷː	x̠ʷː	velar, labial:fricative:−voice	\textsubbar{x}\super w\textlengthmark
x̠ː	x̠ː	velar:fricative:−voice	\textsubbar{x}\textlengthmark
x̩	x̩	velar:fricative:−voice +syllabic	\textipa{\s{x}}
x̩ʲ	x̩ʲ	velar, palatal:fricative:−voice +syllabic	\textipa{\s{x}}\super j
x̩ʲː	x̩ʲː	velar, palatal:fricative:−voice +syllabic	\textipa{\s{x}}\super j\textlengthmark
x̩ʷ	x̩ʷ	velar, labial:fricative:−voice +syllabic	\textipa{\s{x}}\super w
x̩ʷː	x̩ʷː	velar, labial:fricative:−voice +syllabic	\textipa{\s{x}}\super w\textlengthmark
x̩ː	x̩ː	velar:fricative:−voice +syllabic	\textipa{\s{x}}\textlengthmark
y	y	empty:vowel:+high −low −back +round +voice −nasal −spread glottis −constricted glottis	y
yː	yː	empty:vowel:+high −low −back +round +voice −nasal −spread glottis −constricted glottis	y\textlengthmark
ỹ	ỹ	empty:vowel:+high −low −back +round +voice +nasal −spread glottis −constricted glottis	\textipa{\~y}
ỹː	ỹː	empty:vowel:+high −low −back +round +voice +nasal −spread glottis −constricted glottis	\textipa{\~y}\textlengthmark
y̥	y̥	empty:vowel:+high −low −back +round −voice −nasal −spread glottis −constricted glottis	*y
y̥ː	y̥ː	empty:vowel:+high −low −back +round −voice −nasal −spread glottis −constricted glottis	*y\textlengthmark
ỹ̥	ỹ̥	empty:vowel:+high −low −back +round −voice +nasal −spread glottis −constricted glottis	*\textipa{\~y}
ỹ̥ː	ỹ̥ː	empty:vowel:+high −low −back +round −voice +nasal −spread glottis −constricted glottis	*\textipa{\~y}\textlengthmark
y̥̯	y̯̥	empty:vowel:+high −low −back +round −voice −nasal −spread glottis −constricted glottis	*\textroundcap{y}
y̥̯ː	y̯̥ː	empty:vowel:+high −low −back +round −voice −nasal −spread glottis −constricted glottis	*\textroundcap{y}\textlengthmark
ỹ̥̯	ỹ̯̥	empty:vowel:+high −low −back +round −voice +nasal −spread glottis −constricted glottis	*\textipa{\~\textroundcap{y}}
ỹ̥̯ː	ỹ̯̥ː	empty:vowel:+high −low −back +round −voice +nasal −spread glottis −constricted glottis	*\textipa{\~\textroundcap{y}}\textlengthmark
y̯	y̯	empty:vowel:+high −low −back +round +voice −nasal −spread glottis −constricted glottis	\textroundcap{y}
y̯ː	y̯ː	empty:vowel:+high −low −back +round +voice −nasal −spread glottis −constricted glottis	\textroundcap{y}\textlengthmark
ỹ̯	ỹ̯	empty:vowel:+high −low −back +round +voice +nasal −spread glottis −constricted glottis	\textipa{\~\textroundcap{y}}
ỹ̯ː	ỹ̯ː	empty:vowel:+high −low −back +round +voice +nasal −spread glottis −constricted glottis	\textipa{\~\textroundcap{y}}\textlengthmark
z	z	alveolar:fricative:+voice	z
zʲ	zʲ	alveolar, palatal:fricative:+voice	z\super j
zʲː	zʲː	alveolar, palatal:fricative:+voice	z\super j\textlengthmark
zʷ	zʷ	alveolar, labial:fricative:+voice	z\super w
zʷː	zʷː	alveolar, labial:fricative:+voice	z\super w\textlengthmark
zː	zː	alveolar:fricative:+voice	z\textlengthmark
z̩	z̩	alveolar:fricative:+voice +syllabic	\textipa{\s{z}}
z̩ʲ	z̩ʲ	alveolar, palatal:fricative:+voice +syllabic	\textipa{\s{z}}\super j
z̩ʲː	z̩ʲː	alveolar, palatal:fricative:+voice +syllabic	\textipa{\s{z}}\super j\textlengthmark
z̩ʷ	z̩ʷ	alveolar, labial:fricative:+voice +syllabic	\textipa{\s{z}}\super w
z̩ʷː	z̩ʷː	alveolar, labial:fricative:+voice +syllabic	\textipa{\s{z}}\super w\textlengthmark
z̩ː	z̩ː	alveolar:fricative:+voice +syllabic	\textipa{\s{z}}\textlengthmark
æ	æ	empty:vowel:−high +low −back −round +voice −nasal −spread glottis −constricted glottis	\ae
æː	æː	empty:vowel:−high +low −back −round +voice −nasal −spread glottis −constricted glottis	\ae\textlengthmark
æ̃	æ̃	empty:vowel:−high +low −back −round +voice +nasal −spread glottis −constricted glottis	\textipa{\~\ae}
æ̃ː	æ̃ː	empty:vowel:−high +low −back −round +voice +nasal −spread glottis −constricted glottis	\textipa{\~\ae}\textlengthmark
æ̥	æ̥	empty:vowel:−high +low −back −round −voice −nasal −spread glottis −constricted glottis	*\ae
æ̥ː	æ̥ː	empty:vowel:−high +low −back −round −voice −nasal −spread glottis −constricted glottis	*\ae\textlengthmark
æ̥̃	æ̥̃	empty:vowel:−high +low −back −round −voice +nasal −spread glottis −constricted glottis	*\textipa{\~\ae}
æ̥̃ː	æ̥̃ː	empty:vowel:−high +low −back −round −voice +nasal −spread glottis −constricted glottis	*\textipa{\~\ae}\textlengthmark
æ̥̯	æ̯̥	empty:vowel:−high +low −back −round −voice −nasal −spread glottis −constricted glottis	*\textroundcap{\ae}
æ̥̯ː	æ̯̥ː	empty:vowel:−high +low −back −round −voice −nasal −spread glottis −constricted glottis	*\textroundcap{\ae}\textlengthmark
æ̥̯̃	æ̯̥̃	empty:vowel:−high +low −back −round −voice +nasal −spread glottis −constricted glottis	*\textipa{\~\textroundcap{\ae}}
æ̥̯̃ː	æ̯̥̃ː	empty:vowel:−high +low −back −round −voice +nasal −spread glottis −constricted glottis	*\textipa{\~\textroundcap{\ae}}\textlengthmark
æ̯	æ̯	empty:vowel:−high +low −back −round +voice −nasal −spread glottis −constricted glottis	\textroundcap{\ae}
æ̯ː	æ̯ː	empty:vowel:−high +low −back −round +voice −nasal −spread glottis −constricted glottis	\textroundcap{\ae}\textlengthmark
æ̯̃	æ̯̃	empty:vowel:−high +low −back −round +voice +nasal −spread glottis −constricted glottis	\textipa{\~\textroundcap{\ae}}
æ̯̃ː	æ̯̃ː	empty:vowel:−high +low −back −round +voice +nasal −spread glottis −constricted glottis	\textipa{\~\textroundcap{\ae}}\textlengthmark
ð	ð	dental:fricative:+voice	\textipa{D}
ðʲ	ðʲ	dental, palatal:fricative:+voice	\textipa{D}\super j
ðʲː	ðʲː	dental, palatal:fricative:+voice	\textipa{D}\super j\textlengthmark
ðʷ	ðʷ	dental, labial:fricative:+voice	\textipa{D}\super w
ðʷː	ðʷː	dental, labial:fricative:+voice	\textipa{D}\super w\textlengthmark
ðː	ðː	dental:fricative:+voice	\textipa{D}\textlengthmark
ð̩	ð̩	dental:fricative:+voice +syllabic	\textipa{\sD}
ð̩ʲ	ð̩ʲ	dental, palatal:fricative:+voice +syllabic	\textipa{\sD}\super j
ð̩ʲː	ð̩ʲː	dental, palatal:fricative:+voice +syllabic	\textipa{\sD}\super j\textlengthmark
ð̩ʷ	ð̩ʷ	dental, labial:fricative:+voice +syllabic	\textipa{\sD}\super w
ð̩ʷː	ð̩ʷː	dental, labial:fricative:+voice +syllabic	\textipa{\sD}\super w\textlengthmark
ð̩ː	ð̩ː	dental:fricative:+voice +syllabic	\textipa{\sD}\textlengthmark
ø	ø	empty:vowel:−high −low −back +round +voice −nasal −spread glottis −constricted glottis	\o
øː	øː	empty:vowel:−high −low −back +round +voice −nasal −spread glottis −constricted glottis	\o\textlengthmark
ø̃	ø̃	empty:vowel:−high −low −back +round +voice +nasal −spread glottis −constricted glottis	\textipa{\~\o}
ø̃ː	ø̃ː	empty:vowel:−high −low −back +round +voice +nasal −spread glottis −constricted glottis	\textipa{\~\o}\textlengthmark
ø̥	ø̥	empty:vowel:−high −low −back +round −voice −nasal −spread glottis −constricted glottis	*\o
ø̥ː	ø̥ː	empty:vowel:−high −low −back +round −voice −nasal −spread glottis −constricted glottis	*\o\textlengthmark
ø̥̃	ø̥̃	empty:vowel:−high −low −back +round −voice +nasal −spread glottis −constricted glottis	*\textipa{\~\o}
ø̥̃ː	ø̥̃ː	empty:vowel:−high −low −back +round −voice +nasal −spread glottis −constricted glottis	*\textipa{\~\o}\textlengthmark
ø̥̯	ø̯̥	empty:vowel:−high −low −back +round −voice −nasal −spread glottis −constricted glottis	*\textroundcap{\o}
ø̥̯ː	ø̯̥ː	empty:vowel:−high −low −back +round −voice −nasal −spread glottis −constricted glottis	*\textroundcap{\o}\textlengthmark
ø̥̯̃	ø̯̥̃	empty:vowel:−high −low −back +round −voice +nasal −spread glottis −constricted glottis	*\textipa{\~\textroundcap{\o}}
ø̥̯̃ː	ø̯̥̃ː	empty:vowel:−high −low −back +round −voice +nasal −spread glottis −constricted glottis	*\textipa{\~\textroundcap{\o}}\textlengthmark
ø̯	ø̯	empty:vowel:−high −low −back +round +voice −nasal −spread glottis −constricted glottis	\textroundcap{\o}
ø̯ː	ø̯ː	empty:vowel:−high −low −back +round +voice −nasal −spread glottis −constricted glottis	\textroundcap{\o}\textlengthmark
ø̯̃	ø̯̃	empty:vowel:−high −low −back +round +voice +nasal −spread glottis −constricted glottis	\textipa{\~\textroundcap{\o}}
ø̯̃ː	ø̯̃ː	empty:vowel:−high −low −back +round +voice +nasal −spread glottis −constricted glottis	\textipa{\~\textroundcap{\o}}\textlengthmark
ħ	ħ	pharyngeal:fricative:−voice	\textcrh
ħʲ	ħʲ	pharyngeal, palatal:fricative:−voice	\textcrh\super j
ħʲː	ħʲː	pharyngeal, palatal:fricative:−voice	\textcrh\super j\textlengthmark
ħʷ	ħʷ	pharyngeal, labial:fricative:−voice	\textcrh\super w
ħʷː	ħʷː	pharyngeal, labial:fricative:−voice	\textcrh\super w\textlengthmark
ħː	ħː	pharyngeal:fricative:−voice	\textcrh\textlengthmark
ħ̩	ħ̩	pharyngeal:fricative:−voice +syllabic	\textipa{\s{\textcrh}}
ħ̩ʲ	ħ̩ʲ	pharyngeal, palatal:fricative:−voice +syllabic	\textipa{\s{\textcrh}}\super j
ħ̩ʲː	ħ̩ʲː	pharyngeal, palatal:fricative:−voice +syllabic	\textipa{\s{\textcrh}}\super j\textlengthmark
ħ̩ʷ	ħ̩ʷ	pharyngeal, labial:fricative:−voice +syllabic	\textipa{\s{\textcrh}}\super w
ħ̩ʷː	ħ̩ʷː	pharyngeal, labial:fricative:−voice +syllabic	\textipa{\s{\textcrh}}\super w\textlengthmark
ħ̩ː	ħ̩ː	pharyngeal:fricative:−voice +syllabic	\textipa{\s{\textcrh}}\textlengthmark
ŋ	ŋ	velar:nasal:+voice +nasal	\textipa{N}
ŋʰ	ŋʰ	velar:nasal:+voice +nasal +spread glottis	\textipa{N} extsuperscript{h}
ŋʰː	ŋʰː	velar:nasal:+voice +nasal +spread glottis	\textipa{N} extsuperscript{h}\textlengthmark
ŋʲ	ŋʲ	velar, palatal:nasal:+voice +nasal	\textipa{N}\super j
ŋʲʰ	ŋʰʲ	velar, palatal:nasal:+voice +nasal +spread glottis	\textipa{N} extsuperscript{h}\super j
ŋʲʰː	ŋʰʲː	velar, palatal:nasal:+voice +nasal +spread glottis	\textipa{N} extsuperscript{h}\super j\textlengthmark
ŋʲː	ŋʲː	velar, palatal:nasal:+voice +nasal	\textipa{N}\super j\textlengthmark
ŋʷ	ŋʷ	velar, labial:nasal:+voice +nasal	\textipa{N}\super w
ŋʷʰ	ŋʰʷ	velar, labial:nasal:+voice +nasal +spread glottis	\textipa{N} extsuperscript{h}\super w
ŋʷʰː	ŋʰʷː	velar, labial:nasal:+voice +nasal +spread glottis	\textipa{N} extsuperscript{h}\super w\textlengthmark
ŋʷː	ŋʷː	velar, labial:nasal:+voice +nasal	\textipa{N}\super w\textlengthmark
ŋː	ŋː	velar:nasal:+voice +nasal	\textipa{N}\textlengthmark
ŋ̊	ŋ̥	velar:nasal:−voice +nasal	*\textipa{N}
ŋ̍	ŋ̩	velar:nasal:+voice +nasal +syllabic	\textipa{\sN}
ŋ̟	ŋ̟	velar:nasal:+voice +nasal	\begin{IPA}\|+N̟\end{IPA}
ŋ̟ʰ	ŋ̟ʰ	velar:nasal:+voice +nasal +spread glottis	\begin{IPA}\|+N̟\end{IPA} extsuperscript{h}
ŋ̟ʰː	ŋ̟ʰː	velar:nasal:+voice +nasal +spread glottis	\begin{IPA}\|+N̟\end{IPA} extsuperscript{h}\textlengthmark
ŋ̟ʲ	ŋ̟ʲ	velar, palatal:nasal:+voice +nasal	\begin{IPA}\|+N̟\end{IPA}\super j
ŋ̟ʲː	ŋ̟ʲː	velar, palatal:nasal:+voice +nasal	\begin{IPA}\|+N̟\end{IPA}\super j\textlengthmark
ŋ̟ʷ	ŋ̟ʷ	velar, labial:nasal:+voice +nasal	\begin{IPA}\|+N̟\end{IPA}\super w
ŋ̟ʷː	ŋ̟ʷː	velar, labial:nasal:+voice +nasal	\begin{IPA}\|+N̟\end{IPA}\super w\textlengthmark
ŋ̟ː	ŋ̟ː	velar:nasal:+voice +nasal	\begin{IPA}\|+N̟\end{IPA}\textlengthmark
ŋ̠	ŋ̠	velar:nasal:+voice +nasal	\textipa{\=*N}
ŋ̠ʰ	ŋ̠ʰ	velar:nasal:+voice +nasal +spread glottis	\textipa{\=*N} extsuperscript{h}
ŋ̠ʰː	ŋ̠ʰː	velar:nasal:+voice +nasal +spread glottis	\textipa{\=*N} extsuperscript{h}\textlengthmark
ŋ̠ʲ	ŋ̠ʲ	velar, palatal:nasal:+voice +nasal	\textipa{\=*N}\super j
ŋ̠ʲː	ŋ̠ʲː	velar, palatal:nasal:+voice +nasal	\textipa{\=*N}\super j\textlengthmark
ŋ̠ʷ	ŋ̠ʷ	velar, labial:nasal:+voice +nasal	\textipa{\=*N}\super w
ŋ̠ʷː	ŋ̠ʷː	velar, labial:nasal:+voice +nasal	\textipa{\=*N}\super w\textlengthmark
ŋ̠ː	ŋ̠ː	velar:nasal:+voice +nasal	\textipa{\=*N}\textlengthmark
ŋ̥ʰ	ŋ̥ʰ	velar:nasal:−voice +nasal +spread glottis	*\textipa{N} extsuperscript{h}
ŋ̥ʰː	ŋ̥ʰː	velar:nasal:−voice +nasal +spread glottis	*\textipa{N} extsuperscript{h}\textlengthmark
ŋ̥ʲ	ŋ̥ʲ	velar, palatal:nasal:−voice +nasal	*\textipa{N}\super j
ŋ̥ʲʰ	ŋ̥ʰʲ	velar, palatal:nasal:−voice +nasal +spread glottis	*\textipa{N} extsuperscript{h}\super j
ŋ̥ʲʰː	ŋ̥ʰʲː	velar, palatal:nasal:−voice +nasal +spread glottis	*\textipa{N} extsuperscript{h}\super j\textlengthmark
ŋ̥ʲː	ŋ̥ʲː	velar, palatal:nasal:−voice +nasal	*\textipa{N}\super j\textlengthmark
ŋ̥ʷ	ŋ̥ʷ	velar, labial:nasal:−voice +nasal	*\textipa{N}\super w
ŋ̥ʷʰ	ŋ̥ʰʷ	velar, labial:nasal:−voice +nasal +spread glottis	*\textipa{N} extsuperscript{h}\super w
ŋ̥ʷʰː	ŋ̥ʰʷː	velar, labial:nasal:−voice +nasal +spread glottis	*\textipa{N} extsuperscript{h}\super w\textlengthmark
ŋ̥ʷː	ŋ̥ʷː	velar, labial:nasal:−voice +nasal	*\textipa{N}\super w\textlengthmark
ŋ̥ː	ŋ̥ː	velar:nasal:−voice +nasal	*\textipa{N}\textlengthmark
ŋ̩ʲ	ŋ̩ʲ	velar, palatal:nasal:+voice +nasal +syllabic	\textipa{\sN}\super j
ŋ̩ʲː	ŋ̩ʲː	velar, palatal:nasal:+voice +nasal +syllabic	\textipa{\sN}\super j\textlengthmark
ŋ̩ʷ	ŋ̩ʷ	velar, labial:nasal:+voice +nasal +syllabic	\textipa{\sN}\super w
ŋ̩ʷː	ŋ̩ʷː	velar, labial:nasal:+voice +nasal +syllabic	\textipa{\sN}\super w\textlengthmark
ŋ̩ː	ŋ̩ː	velar:nasal:+voice +nasal +syllabic	\textipa{\sN}\textlengthmark
ŋ̩̥	ŋ̥̩	velar:nasal:−voice +nasal +syllabic	*\textipa{\sN}
ŋ̩̥ʲ	ŋ̥̩ʲ	velar, palatal:nasal:−voice +nasal +syllabic	*\textipa{\sN}\super j
ŋ̩̥ʲː	ŋ̥̩ʲː	velar, palatal:nasal:−voice +nasal +syllabic	*\textipa{\sN}\super j\textlengthmark
ŋ̩̥ʷ	ŋ̥̩ʷ	velar, labial:nasal:−voice +nasal +syllabic	*\textipa{\sN}\super w
ŋ̩̥ʷː	ŋ̥̩ʷː	velar, labial:nasal:−voice +nasal +syllabic	*\textipa{\sN}\super w\textlengthmark
ŋ̩̥ː	ŋ̥̩ː	velar:nasal:−voice +nasal +syllabic	*\textipa{\sN}\textlengthmark
œ	œ	empty:vowel:−high −low −back +round +voice −nasal −spread glottis −constricted glottis	\oe
œː	œː	empty:vowel:−high −low −back +round +voice −nasal −spread glottis −constricted glottis	\oe\textlengthmark
œ̃	œ̃	empty:vowel:−high −low −back +round +voice +nasal −spread glottis −constricted glottis	\textipa{\~\oe}
œ̃ː	œ̃ː	empty:vowel:−high −low −back +round +voice +nasal −spread glottis −constricted glottis	\textipa{\~\oe}\textlengthmark
œ̥	œ̥	empty:vowel:−high −low −back +round −voice −nasal −spread glottis −constricted glottis	*\oe
œ̥ː	œ̥ː	empty:vowel:−high −low −back +round −voice −nasal −spread glottis −constricted glottis	*\oe\textlengthmark
œ̥̃	œ̥̃	empty:vowel:−high −low −back +round −voice +nasal −spread glottis −constricted glottis	*\textipa{\~\oe}
œ̥̃ː	œ̥̃ː	empty:vowel:−high −low −back +round −voice +nasal −spread glottis −constricted glottis	*\textipa{\~\oe}\textlengthmark
œ̥̯	œ̯̥	empty:vowel:−high −low −back +round −voice −nasal −spread glottis −constricted glottis	*\textroundcap{\oe}
œ̥̯ː	œ̯̥ː	empty:vowel:−high −low −back +round −voice −nasal −spread glottis −constricted glottis	*\textroundcap{\oe}\textlengthmark
œ̥̯̃	œ̯̥̃	empty:vowel:−high −low −back +round −voice +nasal −spread glottis −constricted glottis	*\textipa{\~\textroundcap{\oe}}
œ̥̯̃ː	œ̯̥̃ː	empty:vowel:−high −low −back +round −voice +nasal −spread glottis −constricted glottis	*\textipa{\~\textroundcap{\oe}}\textlengthmark
œ̯	œ̯	empty:vowel:−high −low −back +round +voice −nasal −spread glottis −constricted glottis	\textroundcap{\oe}
œ̯ː	œ̯ː	empty:vowel:−high −low −back +round +voice −nasal −spread glottis −constricted glottis	\textroundcap{\oe}\textlengthmark
œ̯̃	œ̯̃	empty:vowel:−high −low −back +round +voice +nasal −spread glottis −constricted glottis	\textipa{\~\textroundcap{\oe}}
œ̯̃ː	œ̯̃ː	empty:vowel:−high −low −back +round +voice +nasal −spread glottis −constricted glottis	\textipa{\~\textroundcap{\oe}}\textlengthmark
ɐ	ɐ	empty:vowel:−high +low +back −round +voice −nasal −spread glottis −constricted glottis	\textturna
ɐː	ɐː	empty:vowel:−high +low +back −round +voice −nasal −spread glottis −constricted glottis	\textturna\textlengthmark
ɐ̃	ɐ̃	empty:vowel:−high +low +back −round +voice +nasal −spread glottis −constricted glottis	\textipa{\~\textturna}
ɐ̃ː	ɐ̃ː	empty:vowel:−high +low +back −round +voice +nasal −spread glottis −constricted glottis	\textipa{\~\textturna}\textlengthmark
ɐ̥	ɐ̥	empty:vowel:−high +low +back −round −voice −nasal −spread glottis −constricted glottis	*\textturna
ɐ̥ː	ɐ̥ː	empty:vowel:−high +low +back −round −voice −nasal −spread glottis −constricted glottis	*\textturna\textlengthmark
ɐ̥̃	ɐ̥̃	empty:vowel:−high +low +back −round −voice +nasal −spread glottis −constricted glottis	*\textipa{\~\textturna}
ɐ̥̃ː	ɐ̥̃ː	empty:vowel:−high +low +back −round −voice +nasal −spread glottis −constricted glottis	*\textipa{\~\textturna}\textlengthmark
ɐ̥̯	ɐ̯̥	empty:vowel:−high +low +back −round −voice −nasal −spread glottis −constricted glottis	*\textroundcap{\textturna}
ɐ̥̯ː	ɐ̯̥ː	empty:vowel:−high +low +back −round −voice −nasal −spread glottis −constricted glottis	*\textroundcap{\textturna}\textlengthmark
ɐ̥̯̃	ɐ̯̥̃	empty:vowel:−high +low +back −round −voice +nasal −spread glottis −constricted glottis	*\textipa{\~\textroundcap{\textturna}}
ɐ̥̯̃ː	ɐ̯̥̃ː	empty:vowel:−high +low +back −round −voice +nasal −spread glottis −constricted glottis	*\textipa{\~\textroundcap{\textturna}}\textlengthmark
ɐ̯	ɐ̯	empty:vowel:−high +low +back −round +voice −nasal −spread glottis −constricted glottis	\textroundcap{\textturna}
ɐ̯ː	ɐ̯ː	empty:vowel:−high +low +back −round +voice −nasal −spread glottis −constricted glottis	\textroundcap{\textturna}\textlengthmark
ɐ̯̃	ɐ̯̃	empty:vowel:−high +low +back −round +voice +nasal −spread glottis −constricted glottis	\textipa{\~\textroundcap{\textturna}}
ɐ̯̃ː	ɐ̯̃ː	empty:vowel:−high +low +back −round +voice +nasal −spread glottis −constricted glottis	\textipa{\~\textroundcap{\textturna}}\textlengthmark
ɑ	ɑ	empty:vowel:−high +low +back −round +voice −nasal −spread glottis −constricted glottis	\textscripta
ɑː	ɑː	empty:vowel:−high +low +back −round +voice −nasal −spread glottis −constricted glottis	\textscripta\textlengthmark
ɑ̃	ɑ̃	empty:vowel:−high +low +back −round +voice +nasal −spread glottis −constricted glottis	\textipa{\~\textscripta}
ɑ̃ː	ɑ̃ː	empty:vowel:−high +low +back −round +voice +nasal −spread glottis −constricted glottis	\textipa{\~\textscripta}\textlengthmark
ɑ̥	ɑ̥	empty:vowel:−high +low +back −round −voice −nasal −spread glottis −constricted glottis	*\textscripta
ɑ̥ː	ɑ̥ː	empty:vowel:−high +low +back −round −voice −nasal −spread glottis −constricted glottis	*\textscripta\textlengthmark
ɑ̥̃	ɑ̥̃	empty:vowel:−high +low +back −round −voice +nasal −spread glottis −constricted glottis	*\textipa{\~\textscripta}
ɑ̥̃ː	ɑ̥̃ː	empty:vowel:−high +low +back −round −voice +nasal −spread glottis −constricted glottis	*\textipa{\~\textscripta}\textlengthmark
ɑ̥̯	ɑ̯̥	empty:vowel:−high +low +back −round −voice −nasal −spread glottis −constricted glottis	*\textroundcap{\textscripta}
ɑ̥̯ː	ɑ̯̥ː	empty:vowel:−high +low +back −round −voice −nasal −spread glottis −constricted glottis	*\textroundcap{\textscripta}\textlengthmark
ɑ̥̯̃	ɑ̯̥̃	empty:vowel:−high +low +back −round −voice +nasal −spread glottis −constricted glottis	*\textipa{\~\textroundcap{\textscripta}}
ɑ̥̯̃ː	ɑ̯̥̃ː	empty:vowel:−high +low +back −round −voice +nasal −spread glottis −constricted glottis	*\textipa{\~\textroundcap{\textscripta}}\textlengthmark
ɑ̯	ɑ̯	empty:vowel:−high +low +back −round +voice −nasal −spread glottis −constricted glottis	\textroundcap{\textscripta}
ɑ̯ː	ɑ̯ː	empty:vowel:−high +low +back −round +voice −nasal −spread glottis −constricted glottis	\textroundcap{\textscripta}\textlengthmark
ɑ̯̃	ɑ̯̃	empty:vowel:−high +low +back −round +voice +nasal −spread glottis −constricted glottis	\textipa{\~\textroundcap{\textscripta}}
ɑ̯̃ː	ɑ̯̃ː	empty:vowel:−high +low +back −round +voice +nasal −spread glottis −constricted glottis	\textipa{\~\textroundcap{\textscripta}}\textlengthmark
ɒ	ɒ	empty:vowel:−high +low +back +round +voice −nasal −spread glottis −constricted glottis	\textturnscripta
ɒː	ɒː	empty:vowel:−high +low +back +round +voice −nasal −spread glottis −constricted glottis	\textturnscripta\textlengthmark
ɒ̃	ɒ̃	empty:vowel:−high +low +back +round +voice +nasal −spread glottis −constricted glottis	\textipa{\~\textturnscripta}
ɒ̃ː	ɒ̃ː	empty:vowel:−high +low +back +round +voice +nasal −spread glottis −constricted glottis	\textipa{\~\textturnscripta}\textlengthmark
ɒ̥	ɒ̥	empty:vowel:−high +low +back +round −voice −nasal −spread glottis −constricted glottis	*\textturnscripta
ɒ̥ː	ɒ̥ː	empty:vowel:−high +low +back +round −voice −nasal −spread glottis −constricted glottis	*\textturnscripta\textlengthmark
ɒ̥̃	ɒ̥̃	empty:vowel:−high +low +back +round −voice +nasal −spread glottis −constricted glottis	*\textipa{\~\textturnscripta}
ɒ̥̃ː	ɒ̥̃ː	empty:vowel:−high +low +back +round −voice +nasal −spread glottis −constricted glottis	*\textipa{\~\textturnscripta}\textlengthmark
ɒ̥̯	ɒ̯̥	empty:vowel:−high +low +back +round −voice −nasal −spread glottis −constricted glottis	*\textroundcap{\textturnscripta}
ɒ̥̯ː	ɒ̯̥ː	empty:vowel:−high +low +back +round −voice −nasal −spread glottis −constricted glottis	*\textroundcap{\textturnscripta}\textlengthmark
ɒ̥̯̃	ɒ̯̥̃	empty:vowel:−high +low +back +round −voice +nasal −spread glottis −constricted glottis	*\textipa{\~\textroundcap{\textturnscripta}}
ɒ̥̯̃ː	ɒ̯̥̃ː	empty:vowel:−high +low +back +round −voice +nasal −spread glottis −constricted glottis	*\textipa{\~\textroundcap{\textturnscripta}}\textlengthmark
ɒ̯	ɒ̯	empty:vowel:−high +low +back +round +voice −nasal −spread glottis −constricted glottis	\textroundcap{\textturnscripta}
ɒ̯ː	ɒ̯ː	empty:vowel:−high +low +back +round +voice −nasal −spread glottis −constricted glottis	\textroundcap{\textturnscripta}\textlengthmark
ɒ̯̃	ɒ̯̃	empty:vowel:−high +low +back +round +voice +nasal −spread glottis −constricted glottis	\textipa{\~\textroundcap{\textturnscripta}}
ɒ̯̃ː	ɒ̯̃ː	empty:vowel:−high +low +back +round +voice +nasal −spread glottis −constricted glottis	\textipa{\~\textroundcap{\textturnscripta}}\textlengthmark
ɓ	ɓ	labial:plosive:+voice	\texthtb
ɓʰ	ɓʰ	labial:plosive:+voice +spread glottis	\texthtb extsuperscript{h}
ɓʰː	ɓʰː	labial:plosive:+voice +spread glottis	\texthtb extsuperscript{h}\textlengthmark
ɓʲ	ɓʲ	labial, palatal:plosive:+voice	\texthtb\super j
ɓʲʰ	ɓʰʲ	labial, palatal:plosive:+voice +spread glottis	\texthtb extsuperscript{h}\super j
ɓʲʰː	ɓʰʲː	labial, palatal:plosive:+voice +spread glottis	\texthtb extsuperscript{h}\super j\textlengthmark
ɓʲː	ɓʲː	labial, palatal:plosive:+voice	\texthtb\super j\textlengthmark
ɓʷ	ɓʷ	labial:plosive:+voice	\texthtb\super w
ɓʷʰ	ɓʰʷ	labial:plosive:+voice +spread glottis	\texthtb extsuperscript{h}\super w
ɓʷʰː	ɓʰʷː	labial:plosive:+voice +spread glottis	\texthtb extsuperscript{h}\super w\textlengthmark
ɓʷː	ɓʷː	labial:plosive:+voice	\texthtb\super w\textlengthmark
ɓː	ɓː	labial:plosive:+voice	\texthtb\textlengthmark
ɓ̩	ɓ̩	labial:plosive:+voice +syllabic	\textipa{\s{\texthtb}}
ɓ̩ʲ	ɓ̩ʲ	labial, palatal:plosive:+voice +syllabic	\textipa{\s{\texthtb}}\super j
ɓ̩ʲː	ɓ̩ʲː	labial, palatal:plosive:+voice +syllabic	\textipa{\s{\texthtb}}\super j\textlengthmark
ɓ̩ʷ	ɓ̩ʷ	labial:plosive:+voice +syllabic	\textipa{\s{\texthtb}}\super w
ɓ̩ʷː	ɓ̩ʷː	labial:plosive:+voice +syllabic	\textipa{\s{\texthtb}}\super w\textlengthmark
ɓ̩ː	ɓ̩ː	labial:plosive:+voice +syllabic	\textipa{\s{\texthtb}}\textlengthmark
ɔ	ɔ	empty:vowel:−high −low +back +round +voice −nasal −spread glottis −constricted glottis	\textopeno
ɔː	ɔː	empty:vowel:−high −low +back +round +voice −nasal −spread glottis −constricted glottis	\textopeno\textlengthmark
ɔ̃	ɔ̃	empty:vowel:−high −low +back +round +voice +nasal −spread glottis −constricted glottis	\textipa{\~\textopeno}
ɔ̃ː	ɔ̃ː	empty:vowel:−high −low +back +round +voice +nasal −spread glottis −constricted glottis	\textipa{\~\textopeno}\textlengthmark
ɔ̥	ɔ̥	empty:vowel:−high −low +back +round −voice −nasal −spread glottis −constricted glottis	*\textopeno
ɔ̥ː	ɔ̥ː	empty:vowel:−high −low +back +round −voice −nasal −spread glottis −constricted glottis	*\textopeno\textlengthmark
ɔ̥̃	ɔ̥̃	empty:vowel:−high −low +back +round −voice +nasal −spread glottis −constricted glottis	*\textipa{\~\textopeno}
ɔ̥̃ː	ɔ̥̃ː	empty:vowel:−high −low +back +round −voice +nasal −spread glottis −constricted glottis	*\textipa{\~\textopeno}\textlengthmark
ɔ̥̯	ɔ̯̥	empty:vowel:−high −low +back +round −voice −nasal −spread glottis −constricted glottis	*\textroundcap{\textopeno}
ɔ̥̯ː	ɔ̯̥ː	empty:vowel:−high −low +back +round −voice −nasal −spread glottis −constricted glottis	*\textroundcap{\textopeno}\textlengthmark
ɔ̥̯̃	ɔ̯̥̃	empty:vowel:−high −low +back +round −voice +nasal −spread glottis −constricted glottis	*\textipa{\~\textroundcap{\textopeno}}
ɔ̥̯̃ː	ɔ̯̥̃ː	empty:vowel:−high −low +back +round −voice +nasal −spread glottis −constricted glottis	*\textipa{\~\textroundcap{\textopeno}}\textlengthmark
ɔ̯	ɔ̯	empty:vowel:−high −low +back +round +voice −nasal −spread glottis −constricted glottis	\textroundcap{\textopeno}
ɔ̯ː	ɔ̯ː	empty:vowel:−high −low +back +round +voice −nasal −spread glottis −constricted glottis	\textroundcap{\textopeno}\textlengthmark
ɔ̯̃	ɔ̯̃	empty:vowel:−high −low +back +round +voice +nasal −spread glottis −constricted glottis	\textipa{\~\textroundcap{\textopeno}}
ɔ̯̃ː	ɔ̯̃ː	empty:vowel:−high −low +back +round +voice +nasal −spread glottis −constricted glottis	\textipa{\~\textroundcap{\textopeno}}\textlengthmark
ɕ	ɕ	alveolar, palatal:fricative:−voice	\textctc
ɕʲ	ɕʲ	alveolar, palatal:fricative:−voice	\textctc\super j
ɕʲː	ɕʲː	alveolar, palatal:fricative:−voice	\textctc\super j\textlengthmark
ɕʷ	ɕʷ	alveolar, palatal, labial:fricative:−voice	\textctc\super w
ɕʷː	ɕʷː	alveolar, palatal, labial:fricative:−voice	\textctc\super w\textlengthmark
ɕː	ɕː	alveolar, palatal:fricative:−voice	\textctc\textlengthmark
ɕ̩	ɕ̩	alveolar, palatal:fricative:−voice +syllabic	\textipa{\s{\textctc}}
ɕ̩ʲ	ɕ̩ʲ	alveolar, palatal:fricative:−voice +syllabic	\textipa{\s{\textctc}}\super j
ɕ̩ʲː	ɕ̩ʲː	alveolar, palatal:fricative:−voice +syllabic	\textipa{\s{\textctc}}\super j\textlengthmark
ɕ̩ʷ	ɕ̩ʷ	alveolar, palatal, labial:fricative:−voice +syllabic	\textipa{\s{\textctc}}\super w
ɕ̩ʷː	ɕ̩ʷː	alveolar, palatal, labial:fricative:−voice +syllabic	\textipa{\s{\textctc}}\super w\textlengthmark
ɕ̩ː	ɕ̩ː	alveolar, palatal:fricative:−voice +syllabic	\textipa{\s{\textctc}}\textlengthmark
ɖ	ɖ	retroflex:plosive:+voice	\textrtaild
ɖʐ	ɖ͡ʐ	retroflex:affricate:+voice	\t{ɖ͡\textrtailz}
ɖʐʰ	ɖ͡ʐʰ	retroflex:affricate:+voice +spread glottis	\t{ɖ͡\textrtailz} extsuperscript{h}
ɖʐʰː	ɖ͡ʐʰː	retroflex:affricate:+voice +spread glottis	\t{ɖ͡\textrtailz} extsuperscript{h}\textlengthmark
ɖʐʲ	ɖ͡ʐʲ	retroflex, palatal:affricate:+voice	\t{ɖ͡\textrtailz}\super j
ɖʐʲː	ɖ͡ʐʲː	retroflex, palatal:affricate:+voice	\t{ɖ͡\textrtailz}\super j\textlengthmark
ɖʐʷ	ɖ͡ʐʷ	retroflex, labial:affricate:+voice	\t{ɖ͡\textrtailz}\super w
ɖʐʷː	ɖ͡ʐʷː	retroflex, labial:affricate:+voice	\t{ɖ͡\textrtailz}\super w\textlengthmark
ɖʐː	ɖ͡ʐː	retroflex:affricate:+voice	\t{ɖ͡\textrtailz}\textlengthmark
ɖʰ	ɖʰ	retroflex:plosive:+voice +spread glottis	\textrtaild extsuperscript{h}
ɖʰː	ɖʰː	retroflex:plosive:+voice +spread glottis	\textrtaild extsuperscript{h}\textlengthmark
ɖʲ	ɖʲ	retroflex, palatal:plosive:+voice	\textrtaild\super j
ɖʲʰ	ɖʰʲ	retroflex, palatal:plosive:+voice +spread glottis	\textrtaild extsuperscript{h}\super j
ɖʲʰː	ɖʰʲː	retroflex, palatal:plosive:+voice +spread glottis	\textrtaild extsuperscript{h}\super j\textlengthmark
ɖʲː	ɖʲː	retroflex, palatal:plosive:+voice	\textrtaild\super j\textlengthmark
ɖʷ	ɖʷ	retroflex, labial:plosive:+voice	\textrtaild\super w
ɖʷʰ	ɖʰʷ	retroflex, labial:plosive:+voice +spread glottis	\textrtaild extsuperscript{h}\super w
ɖʷʰː	ɖʰʷː	retroflex, labial:plosive:+voice +spread glottis	\textrtaild extsuperscript{h}\super w\textlengthmark
ɖʷː	ɖʷː	retroflex, labial:plosive:+voice	\textrtaild\super w\textlengthmark
ɖː	ɖː	retroflex:plosive:+voice	\textrtaild\textlengthmark
ɖ̩	ɖ̩	retroflex:plosive:+voice +syllabic	\textipa{\s{\textrtaild}}
ɖ̩ʲ	ɖ̩ʲ	retroflex, palatal:plosive:+voice +syllabic	\textipa{\s{\textrtaild}}\super j
ɖ̩ʲː	ɖ̩ʲː	retroflex, palatal:plosive:+voice +syllabic	\textipa{\s{\textrtaild}}\super j\textlengthmark
ɖ̩ʷ	ɖ̩ʷ	retroflex, labial:plosive:+voice +syllabic	\textipa{\s{\textrtaild}}\super w
ɖ̩ʷː	ɖ̩ʷː	retroflex, labial:plosive:+voice +syllabic	\textipa{\s{\textrtaild}}\super w\textlengthmark
ɖ̩ː	ɖ̩ː	retroflex:plosive:+voice +syllabic	\textipa{\s{\textrtaild}}\textlengthmark
ɗ	ɗ	dental:plosive:+voice	\texthtd
ɗʰ	ɗʰ	dental:plosive:+voice +spread glottis	\texthtd extsuperscript{h}
ɗʰː	ɗʰː	dental:plosive:+voice +spread glottis	\texthtd extsuperscript{h}\textlengthmark
ɗʲ	ɗʲ	dental, palatal:plosive:+voice	\texthtd\super j
ɗʲʰ	ɗʰʲ	dental, palatal:plosive:+voice +spread glottis	\texthtd extsuperscript{h}\super j
ɗʲʰː	ɗʰʲː	dental, palatal:plosive:+voice +spread glottis	\texthtd extsuperscript{h}\super j\textlengthmark
ɗʲː	ɗʲː	dental, palatal:plosive:+voice	\texthtd\super j\textlengthmark
ɗʷ	ɗʷ	dental, labial:plosive:+voice	\texthtd\super w
ɗʷʰ	ɗʰʷ	dental, labial:plosive:+voice +spread glottis	\texthtd extsuperscript{h}\super w
ɗʷʰː	ɗʰʷː	dental, labial:plosive:+voice +spread glottis	\texthtd extsuperscript{h}\super w\textlengthmark
ɗʷː	ɗʷː	dental, labial:plosive:+voice	\texthtd\super w\textlengthmark
ɗː	ɗː	dental:plosive:+voice	\texthtd\textlengthmark
ɗ̩	ɗ̩	dental:plosive:+voice +syllabic	\textipa{\s{\texthtd}}
ɗ̩ʲ	ɗ̩ʲ	dental, palatal:plosive:+voice +syllabic	\textipa{\s{\texthtd}}\super j
ɗ̩ʲː	ɗ̩ʲː	dental, palatal:plosive:+voice +syllabic	\textipa{\s{\texthtd}}\super j\textlengthmark
ɗ̩ʷ	ɗ̩ʷ	dental, labial:plosive:+voice +syllabic	\textipa{\s{\texthtd}}\super w
ɗ̩ʷː	ɗ̩ʷː	dental, labial:plosive:+voice +syllabic	\textipa{\s{\texthtd}}\super w\textlengthmark
ɗ̩ː	ɗ̩ː	dental:plosive:+voice +syllabic	\textipa{\s{\texthtd}}\textlengthmark
ɘ	ɘ	empty:vowel:−high −low +back −round +voice −nasal −spread glottis −constricted glottis	\textreve
ɘː	ɘː	empty:vowel:−high −low +back −round +voice −nasal −spread glottis −constricted glottis	\textreve\textlengthmark
ɘ̃	ɘ̃	empty:vowel:−high −low +back −round +voice +nasal −spread glottis −constricted glottis	\textipa{\~\textreve}
ɘ̃ː	ɘ̃ː	empty:vowel:−high −low +back −round +voice +nasal −spread glottis −constricted glottis	\textipa{\~\textreve}\textlengthmark
ɘ̥	ɘ̥	empty:vowel:−high −low +back −round −voice −nasal −spread glottis −constricted glottis	*\textreve
ɘ̥ː	ɘ̥ː	empty:vowel:−high −low +back −round −voice −nasal −spread glottis −constricted glottis	*\textreve\textlengthmark
ɘ̥̃	ɘ̥̃	empty:vowel:−high −low +back −round −voice +nasal −spread glottis −constricted glottis	*\textipa{\~\textreve}
ɘ̥̃ː	ɘ̥̃ː	empty:vowel:−high −low +back −round −voice +nasal −spread glottis −constricted glottis	*\textipa{\~\textreve}\textlengthmark
ɘ̥̯	ɘ̯̥	empty:vowel:−high −low +back −round −voice −nasal −spread glottis −constricted glottis	*\textroundcap{\textreve}
ɘ̥̯ː	ɘ̯̥ː	empty:vowel:−high −low +back −round −voice −nasal −spread glottis −constricted glottis	*\textroundcap{\textreve}\textlengthmark
ɘ̥̯̃	ɘ̯̥̃	empty:vowel:−high −low +back −round −voice +nasal −spread glottis −constricted glottis	*\textipa{\~\textroundcap{\textreve}}
ɘ̥̯̃ː	ɘ̯̥̃ː	empty:vowel:−high −low +back −round −voice +nasal −spread glottis −constricted glottis	*\textipa{\~\textroundcap{\textreve}}\textlengthmark
ɘ̯	ɘ̯	empty:vowel:−high −low +back −round +voice −nasal −spread glottis −constricted glottis	\textroundcap{\textreve}
ɘ̯ː	ɘ̯ː	empty:vowel:−high −low +back −round +voice −nasal −spread glottis −constricted glottis	\textroundcap{\textreve}\textlengthmark
ɘ̯̃	ɘ̯̃	empty:vowel:−high −low +back −round +voice +nasal −spread glottis −constricted glottis	\textipa{\~\textroundcap{\textreve}}
ɘ̯̃ː	ɘ̯̃ː	empty:vowel:−high −low +back −round +voice +nasal −spread glottis −constricted glottis	\textipa{\~\textroundcap{\textreve}}\textlengthmark
ə	ə	empty:vowel:−high −low +back −round +voice −nasal −spread glottis −constricted glottis	\textschwa
əː	əː	empty:vowel:−high −low +back −round +voice −nasal −spread glottis −constricted glottis	\textschwa\textlengthmark
ə˞	ɚ	empty:vowel:−high −low +back −round +voice −nasal −spread glottis −constricted glottis	\textrhookschwa
ə˞ː	ɚː	empty:vowel:−high −low +back −round +voice −nasal −spread glottis −constricted glottis	\textrhookschwa\textlengthmark
ə̃	ə̃	empty:vowel:−high −low +back −round +voice +nasal −spread glottis −constricted glottis	\textipa{\~\textschwa}
ə̃ː	ə̃ː	empty:vowel:−high −low +back −round +voice +nasal −spread glottis −constricted glottis	\textipa{\~\textschwa}\textlengthmark
ə̃˞	ɚ̃	empty:vowel:−high −low +back −round +voice +nasal −spread glottis −constricted glottis	\textipa{\~\textrhookschwa}
ə̃˞ː	ɚ̃ː	empty:vowel:−high −low +back −round +voice +nasal −spread glottis −constricted glottis	\textipa{\~\textrhookschwa}\textlengthmark
ə̥	ə̥	empty:vowel:−high −low +back −round −voice −nasal −spread glottis −constricted glottis	*\textschwa
ə̥ː	ə̥ː	empty:vowel:−high −low +back −round −voice −nasal −spread glottis −constricted glottis	*\textschwa\textlengthmark
ə̥˞	ɚ̥	empty:vowel:−high −low +back −round −voice −nasal −spread glottis −constricted glottis	*\textrhookschwa
ə̥˞ː	ɚ̥ː	empty:vowel:−high −low +back −round −voice −nasal −spread glottis −constricted glottis	*\textrhookschwa\textlengthmark
ə̥̃	ə̥̃	empty:vowel:−high −low +back −round −voice +nasal −spread glottis −constricted glottis	*\textipa{\~\textschwa}
ə̥̃ː	ə̥̃ː	empty:vowel:−high −low +back −round −voice +nasal −spread glottis −constricted glottis	*\textipa{\~\textschwa}\textlengthmark
ə̥̃˞	ɚ̥̃	empty:vowel:−high −low +back −round −voice +nasal −spread glottis −constricted glottis	*\textipa{\~\textrhookschwa}
ə̥̃˞ː	ɚ̥̃ː	empty:vowel:−high −low +back −round −voice +nasal −spread glottis −constricted glottis	*\textipa{\~\textrhookschwa}\textlengthmark
ə̥̯	ə̯̥	empty:vowel:−high −low +back −round −voice −nasal −spread glottis −constricted glottis	*\textroundcap{\textschwa}
ə̥̯ː	ə̯̥ː	empty:vowel:−high −low +back −round −voice −nasal −spread glottis −constricted glottis	*\textroundcap{\textschwa}\textlengthmark
ə̥̯˞	ɚ̯̥	empty:vowel:−high −low +back −round −voice −nasal −spread glottis −constricted glottis	*\textroundcap{\textrhookschwa}
ə̥̯˞ː	ɚ̯̥ː	empty:vowel:−high −low +back −round −voice −nasal −spread glottis −constricted glottis	*\textroundcap{\textrhookschwa}\textlengthmark
ə̥̯̃	ə̯̥̃	empty:vowel:−high −low +back −round −voice +nasal −spread glottis −constricted glottis	*\textipa{\~\textroundcap{\textschwa}}
ə̥̯̃ː	ə̯̥̃ː	empty:vowel:−high −low +back −round −voice +nasal −spread glottis −constricted glottis	*\textipa{\~\textroundcap{\textschwa}}\textlengthmark
ə̥̯̃˞	ɚ̯̥̃	empty:vowel:−high −low +back −round −voice +nasal −spread glottis −constricted glottis	*\textipa{\~\textroundcap{\textrhookschwa}}
ə̥̯̃˞ː	ɚ̯̥̃ː	empty:vowel:−high −low +back −round −voice +nasal −spread glottis −constricted glottis	*\textipa{\~\textroundcap{\textrhookschwa}}\textlengthmark
ə̯	ə̯	empty:vowel:−high −low +back −round +voice −nasal −spread glottis −constricted glottis	\textroundcap{\textschwa}
ə̯ː	ə̯ː	empty:vowel:−high −low +back −round +voice −nasal −spread glottis −constricted glottis	\textroundcap{\textschwa}\textlengthmark
ə̯˞	ɚ̯	empty:vowel:−high −low +back −round +voice −nasal −spread glottis −constricted glottis	\textroundcap{\textrhookschwa}
ə̯˞ː	ɚ̯ː	empty:vowel:−high −low +back −round +voice −nasal −spread glottis −constricted glottis	\textroundcap{\textrhookschwa}\textlengthmark
ə̯̃	ə̯̃	empty:vowel:−high −low +back −round +voice +nasal −spread glottis −constricted glottis	\textipa{\~\textroundcap{\textschwa}}
ə̯̃ː	ə̯̃ː	empty:vowel:−high −low +back −round +voice +nasal −spread glottis −constricted glottis	\textipa{\~\textroundcap{\textschwa}}\textlengthmark
ə̯̃˞	ɚ̯̃	empty:vowel:−high −low +back −round +voice +nasal −spread glottis −constricted glottis	\textipa{\~\textroundcap{\textrhookschwa}}
ə̯̃˞ː	ɚ̯̃ː	empty:vowel:−high −low +back −round +voice +nasal −spread glottis −constricted glottis	\textipa{\~\textroundcap{\textrhookschwa}}\textlengthmark
ɛ	ɛ	empty:vowel:−high −low −back −round +voice −nasal −spread glottis −constricted glottis	\textipa{E}
ɛː	ɛː	empty:vowel:−high −low −back −round +voice −nasal −spread glottis −constricted glottis	\textipa{E}\textlengthmark
ɛ̃	ɛ̃	empty:vowel:−high −low −back −round +voice +nasal −spread glottis −constricted glottis	\textipa{\~\textipa{E}}
ɛ̃ː	ɛ̃ː	empty:vowel:−high −low −back −round +voice +nasal −spread glottis −constricted glottis	\textipa{\~\textipa{E}}\textlengthmark
ɛ̥	ɛ̥	empty:vowel:−high −low −back −round −voice −nasal −spread glottis −constricted glottis	*\textipa{E}
ɛ̥ː	ɛ̥ː	empty:vowel:−high −low −back −round −voice −nasal −spread glottis −constricted glottis	*\textipa{E}\textlengthmark
ɛ̥̃	ɛ̥̃	empty:vowel:−high −low −back −round −voice +nasal −spread glottis −constricted glottis	*\textipa{\~\textipa{E}}
ɛ̥̃ː	ɛ̥̃ː	empty:vowel:−high −low −back −round −voice +nasal −spread glottis −constricted glottis	*\textipa{\~\textipa{E}}\textlengthmark
ɛ̥̯	ɛ̯̥	empty:vowel:−high −low −back −round −voice −nasal −spread glottis −constricted glottis	*\textroundcap{\textipa{E}}
ɛ̥̯ː	ɛ̯̥ː	empty:vowel:−high −low −back −round −voice −nasal −spread glottis −constricted glottis	*\textroundcap{\textipa{E}}\textlengthmark
ɛ̥̯̃	ɛ̯̥̃	empty:vowel:−high −low −back −round −voice +nasal −spread glottis −constricted glottis	*\textipa{\~\textroundcap{\textipa{E}}}
ɛ̥̯̃ː	ɛ̯̥̃ː	empty:vowel:−high −low −back −round −voice +nasal −spread glottis −constricted glottis	*\textipa{\~\textroundcap{\textipa{E}}}\textlengthmark
ɛ̯	ɛ̯	empty:vowel:−high −low −back −round +voice −nasal −spread glottis −constricted glottis	\textroundcap{\textipa{E}}
ɛ̯ː	ɛ̯ː	empty:vowel:−high −low −back −round +voice −nasal −spread glottis −constricted glottis	\textroundcap{\textipa{E}}\textlengthmark
ɛ̯̃	ɛ̯̃	empty:vowel:−high −low −back −round +voice +nasal −spread glottis −constricted glottis	\textipa{\~\textroundcap{\textipa{E}}}
ɛ̯̃ː	ɛ̯̃ː	empty:vowel:−high −low −back −round +voice +nasal −spread glottis −constricted glottis	\textipa{\~\textroundcap{\textipa{E}}}\textlengthmark
ɜ	ɜ	empty:vowel:−high −low +back −round +voice −nasal −spread glottis −constricted glottis	\textipa{3}
ɜː	ɜː	empty:vowel:−high −low +back −round +voice −nasal −spread glottis −constricted glottis	\textipa{3}\textlengthmark
ɜ˞	ɝ	empty:vowel:−high −low +back −round +voice −nasal −spread glottis −constricted glottis	\textrhookrevepsilon
ɜ˞ː	ɝː	empty:vowel:−high −low +back −round +voice −nasal −spread glottis −constricted glottis	\textrhookrevepsilon\textlengthmark
ɜ̃	ɜ̃	empty:vowel:−high −low +back −round +voice +nasal −spread glottis −constricted glottis	\textipa{\~\textipa{3}}
ɜ̃ː	ɜ̃ː	empty:vowel:−high −low +back −round +voice +nasal −spread glottis −constricted glottis	\textipa{\~\textipa{3}}\textlengthmark
ɜ̃˞	ɝ̃	empty:vowel:−high −low +back −round +voice +nasal −spread glottis −constricted glottis	\textipa{\~\textrhookrevepsilon}
ɜ̃˞ː	ɝ̃ː	empty:vowel:−high −low +back −round +voice +nasal −spread glottis −constricted glottis	\textipa{\~\textrhookrevepsilon}\textlengthmark
ɜ̥	ɜ̥	empty:vowel:−high −low +back −round −voice −nasal −spread glottis −constricted glottis	*\textipa{3}
ɜ̥ː	ɜ̥ː	empty:vowel:−high −low +back −round −voice −nasal −spread glottis −constricted glottis	*\textipa{3}\textlengthmark
ɜ̥˞	ɝ̥	empty:vowel:−high −low +back −round −voice −nasal −spread glottis −constricted glottis	*\textrhookrevepsilon
ɜ̥˞ː	ɝ̥ː	empty:vowel:−high −low +back −round −voice −nasal −spread glottis −constricted glottis	*\textrhookrevepsilon\textlengthmark
ɜ̥̃	ɜ̥̃	empty:vowel:−high −low +back −round −voice +nasal −spread glottis −constricted glottis	*\textipa{\~\textipa{3}}
ɜ̥̃ː	ɜ̥̃ː	empty:vowel:−high −low +back −round −voice +nasal −spread glottis −constricted glottis	*\textipa{\~\textipa{3}}\textlengthmark
ɜ̥̃˞	ɝ̥̃	empty:vowel:−high −low +back −round −voice +nasal −spread glottis −constricted glottis	*\textipa{\~\textrhookrevepsilon}
ɜ̥̃˞ː	ɝ̥̃ː	empty:vowel:−high −low +back −round −voice +nasal −spread glottis −constricted glottis	*\textipa{\~\textrhookrevepsilon}\textlengthmark
ɜ̥̯	ɜ̯̥	empty:vowel:−high −low +back −round −voice −nasal −spread glottis −constricted glottis	*\textroundcap{\textipa{3}}
ɜ̥̯ː	ɜ̯̥ː	empty:vowel:−high −low +back −round −voice −nasal −spread glottis −constricted glottis	*\textroundcap{\textipa{3}}\textlengthmark
ɜ̥̯˞	ɝ̯̥	empty:vowel:−high −low +back −round −voice −nasal −spread glottis −constricted glottis	*\textroundcap{\textrhookrevepsilon}
ɜ̥̯˞ː	ɝ̯̥ː	empty:vowel:−high −low +back −round −voice −nasal −spread glottis −constricted glottis	*\textroundcap{\textrhookrevepsilon}\textlengthmark
ɜ̥̯̃	ɜ̯̥̃	empty:vowel:−high −low +back −round −voice +nasal −spread glottis −constricted glottis	*\textipa{\~\textroundcap{\textipa{3}}}
ɜ̥̯̃ː	ɜ̯̥̃ː	empty:vowel:−high −low +back −round −voice +nasal −spread glottis −constricted glottis	*\textipa{\~\textroundcap{\textipa{3}}}\textlengthmark
ɜ̥̯̃˞	ɝ̯̥̃	empty:vowel:−high −low +back −round −voice +nasal −spread glottis −constricted glottis	*\textipa{\~\textroundcap{\textrhookrevepsilon}}
ɜ̥̯̃˞ː	ɝ̯̥̃ː	empty:vowel:−high −low +back −round −voice +nasal −spread glottis −constricted glottis	*\textipa{\~\textroundcap{\textrhookrevepsilon}}\textlengthmark
ɜ̯	ɜ̯	empty:vowel:−high −low +back −round +voice −nasal −spread glottis −constricted glottis	\textroundcap{\textipa{3}}
ɜ̯ː	ɜ̯ː	empty:vowel:−high −low +back −round +voice −nasal −spread glottis −constricted glottis	\textroundcap{\textipa{3}}\textlengthmark
ɜ̯˞	ɝ̯	empty:vowel:−high −low +back −round +voice −nasal −spread glottis −constricted glottis	\textroundcap{\textrhookrevepsilon}
ɜ̯˞ː	ɝ̯ː	empty:vowel:−high −low +back −round +voice −nasal −spread glottis −constricted glottis	\textroundcap{\textrhookrevepsilon}\textlengthmark
ɜ̯̃	ɜ̯̃	empty:vowel:−high −low +back −round +voice +nasal −spread glottis −constricted glottis	\textipa{\~\textroundcap{\textipa{3}}}
ɜ̯̃ː	ɜ̯̃ː	empty:vowel:−high −low +back −round +voice +nasal −spread glottis −constricted glottis	\textipa{\~\textroundcap{\textipa{3}}}\textlengthmark
ɜ̯̃˞	ɝ̯̃	empty:vowel:−high −low +back −round +voice +nasal −spread glottis −constricted glottis	\textipa{\~\textroundcap{\textrhookrevepsilon}}
ɜ̯̃˞ː	ɝ̯̃ː	empty:vowel:−high −low +back −round +voice +nasal −spread glottis −constricted glottis	\textipa{\~\textroundcap{\textrhookrevepsilon}}\textlengthmark
ɞ	ɞ	empty:vowel:−high −low +back +round +voice −nasal −spread glottis −constricted glottis	\textcloseepsilon
ɞː	ɞː	empty:vowel:−high −low +back +round +voice −nasal −spread glottis −constricted glottis	\textcloseepsilon\textlengthmark
ɞ̃	ɞ̃	empty:vowel:−high −low +back +round +voice +nasal −spread glottis −constricted glottis	\textipa{\~\textcloseepsilon}
ɞ̃ː	ɞ̃ː	empty:vowel:−high −low +back +round +voice +nasal −spread glottis −constricted glottis	\textipa{\~\textcloseepsilon}\textlengthmark
ɞ̥	ɞ̥	empty:vowel:−high −low +back +round −voice −nasal −spread glottis −constricted glottis	*\textcloseepsilon
ɞ̥ː	ɞ̥ː	empty:vowel:−high −low +back +round −voice −nasal −spread glottis −constricted glottis	*\textcloseepsilon\textlengthmark
ɞ̥̃	ɞ̥̃	empty:vowel:−high −low +back +round −voice +nasal −spread glottis −constricted glottis	*\textipa{\~\textcloseepsilon}
ɞ̥̃ː	ɞ̥̃ː	empty:vowel:−high −low +back +round −voice +nasal −spread glottis −constricted glottis	*\textipa{\~\textcloseepsilon}\textlengthmark
ɞ̥̯	ɞ̯̥	empty:vowel:−high −low +back +round −voice −nasal −spread glottis −constricted glottis	*\textroundcap{\textcloseepsilon}
ɞ̥̯ː	ɞ̯̥ː	empty:vowel:−high −low +back +round −voice −nasal −spread glottis −constricted glottis	*\textroundcap{\textcloseepsilon}\textlengthmark
ɞ̥̯̃	ɞ̯̥̃	empty:vowel:−high −low +back +round −voice +nasal −spread glottis −constricted glottis	*\textipa{\~\textroundcap{\textcloseepsilon}}
ɞ̥̯̃ː	ɞ̯̥̃ː	empty:vowel:−high −low +back +round −voice +nasal −spread glottis −constricted glottis	*\textipa{\~\textroundcap{\textcloseepsilon}}\textlengthmark
ɞ̯	ɞ̯	empty:vowel:−high −low +back +round +voice −nasal −spread glottis −constricted glottis	\textroundcap{\textcloseepsilon}
ɞ̯ː	ɞ̯ː	empty:vowel:−high −low +back +round +voice −nasal −spread glottis −constricted glottis	\textroundcap{\textcloseepsilon}\textlengthmark
ɞ̯̃	ɞ̯̃	empty:vowel:−high −low +back +round +voice +nasal −spread glottis −constricted glottis	\textipa{\~\textroundcap{\textcloseepsilon}}
ɞ̯̃ː	ɞ̯̃ː	empty:vowel:−high −low +back +round +voice +nasal −spread glottis −constricted glottis	\textipa{\~\textroundcap{\textcloseepsilon}}\textlengthmark
ɟ	ɟ	palatal:plosive:+voice	\textbardotlessj
ɟʝ	ɟ͡ʝ	palatal:affricate:+voice	\t{ɟ͡\textctj}
ɟʝʰ	ɟ͡ʝʰ	palatal:affricate:+voice +spread glottis	\t{ɟ͡\textctj} extsuperscript{h}
ɟʝʰː	ɟ͡ʝʰː	palatal:affricate:+voice +spread glottis	\t{ɟ͡\textctj} extsuperscript{h}\textlengthmark
ɟʝʲ	ɟ͡ʝʲ	palatal:affricate:+voice	\t{ɟ͡\textctj}\super j
ɟʝʲː	ɟ͡ʝʲː	palatal:affricate:+voice	\t{ɟ͡\textctj}\super j\textlengthmark
ɟʝʷ	ɟ͡ʝʷ	palatal, labial:affricate:+voice	\t{ɟ͡\textctj}\super w
ɟʝʷː	ɟ͡ʝʷː	palatal, labial:affricate:+voice	\t{ɟ͡\textctj}\super w\textlengthmark
ɟʝː	ɟ͡ʝː	palatal:affricate:+voice	\t{ɟ͡\textctj}\textlengthmark
ɟʰ	ɟʰ	palatal:plosive:+voice +spread glottis	\textbardotlessj extsuperscript{h}
ɟʰː	ɟʰː	palatal:plosive:+voice +spread glottis	\textbardotlessj extsuperscript{h}\textlengthmark
ɟʲ	ɟʲ	palatal:plosive:+voice	\textbardotlessj\super j
ɟʲʰ	ɟʰʲ	palatal:plosive:+voice +spread glottis	\textbardotlessj extsuperscript{h}\super j
ɟʲʰː	ɟʰʲː	palatal:plosive:+voice +spread glottis	\textbardotlessj extsuperscript{h}\super j\textlengthmark
ɟʲː	ɟʲː	palatal:plosive:+voice	\textbardotlessj\super j\textlengthmark
ɟʷ	ɟʷ	palatal, labial:plosive:+voice	\textbardotlessj\super w
ɟʷʰ	ɟʰʷ	palatal, labial:plosive:+voice +spread glottis	\textbardotlessj extsuperscript{h}\super w
ɟʷʰː	ɟʰʷː	palatal, labial:plosive:+voice +spread glottis	\textbardotlessj extsuperscript{h}\super w\textlengthmark
ɟʷː	ɟʷː	palatal, labial:plosive:+voice	\textbardotlessj\super w\textlengthmark
ɟː	ɟː	palatal:plosive:+voice	\textbardotlessj\textlengthmark
ɟ̩	ɟ̩	palatal:plosive:+voice +syllabic	\textipa{\s{\textbardotlessj}}
ɟ̩ʲ	ɟ̩ʲ	palatal:plosive:+voice +syllabic	\textipa{\s{\textbardotlessj}}\super j
ɟ̩ʲː	ɟ̩ʲː	palatal:plosive:+voice +syllabic	\textipa{\s{\textbardotlessj}}\super j\textlengthmark
ɟ̩ʷ	ɟ̩ʷ	palatal, labial:plosive:+voice +syllabic	\textipa{\s{\textbardotlessj}}\super w
ɟ̩ʷː	ɟ̩ʷː	palatal, labial:plosive:+voice +syllabic	\textipa{\s{\textbardotlessj}}\super w\textlengthmark
ɟ̩ː	ɟ̩ː	palatal:plosive:+voice +syllabic	\textipa{\s{\textbardotlessj}}\textlengthmark
ɠ	ɠ	velar:plosive:+voice	\texthtg
ɠʰ	ɠʰ	velar:plosive:+voice +spread glottis	\texthtg extsuperscript{h}
ɠʰː	ɠʰː	velar:plosive:+voice +spread glottis	\texthtg extsuperscript{h}\textlengthmark
ɠʲ	ɠʲ	velar, palatal:plosive:+voice	\texthtg\super j
ɠʲʰ	ɠʰʲ	velar, palatal:plosive:+voice +spread glottis	\texthtg extsuperscript{h}\super j
ɠʲʰː	ɠʰʲː	velar, palatal:plosive:+voice +spread glottis	\texthtg extsuperscript{h}\super j\textlengthmark
ɠʲː	ɠʲː	velar, palatal:plosive:+voice	\texthtg\super j\textlengthmark
ɠʷ	ɠʷ	velar, labial:plosive:+voice	\texthtg\super w
ɠʷʰ	ɠʰʷ	velar, labial:plosive:+voice +spread glottis	\texthtg extsuperscript{h}\super w
ɠʷʰː	ɠʰʷː	velar, labial:plosive:+voice +spread glottis	\texthtg extsuperscript{h}\super w\textlengthmark
ɠʷː	ɠʷː	velar, labial:plosive:+voice	\texthtg\super w\textlengthmark
ɠː	ɠː	velar:plosive:+voice	\texthtg\textlengthmark
ɠ̩	ɠ̩	velar:plosive:+voice +syllabic	\textipa{\s{\texthtg}}
ɠ̩ʲ	ɠ̩ʲ	velar, palatal:plosive:+voice +syllabic	\textipa{\s{\texthtg}}\super j
ɠ̩ʲː	ɠ̩ʲː	velar, palatal:plosive:+voice +syllabic	\textipa{\s{\texthtg}}\super j\textlengthmark
ɠ̩ʷ	ɠ̩ʷ	velar, labial:plosive:+voice +syllabic	\textipa{\s{\texthtg}}\super w
ɠ̩ʷː	ɠ̩ʷː	velar, labial:plosive:+voice +syllabic	\textipa{\s{\texthtg}}\super w\textlengthmark
ɠ̩ː	ɠ̩ː	velar:plosive:+voice +syllabic	\textipa{\s{\texthtg}}\textlengthmark
ɢ	ɢ	uvular:plosive:+voice	\textscg
ɢʁ	ɢ͡ʁ	uvular:affricate:+voice	\t{\textscg \textipa{K}}
ɢʁʰ	ɢ͡ʁʰ	uvular:affricate:+voice +spread glottis	\t{\textscg \textipa{K}} extsuperscript{h}
ɢʁʰː	ɢ͡ʁʰː	uvular:affricate:+voice +spread glottis	\t{\textscg \textipa{K}} extsuperscript{h}\textlengthmark
ɢʁʲ	ɢ͡ʁʲ	uvular, palatal:affricate:+voice	\t{\textscg \textipa{K}}\super j
ɢʁʲː	ɢ͡ʁʲː	uvular, palatal:affricate:+voice	\t{\textscg \textipa{K}}\super j\textlengthmark
ɢʁʷ	ɢ͡ʁʷ	uvular, labial:affricate:+voice	\t{\textscg \textipa{K}}\super w
ɢʁʷː	ɢ͡ʁʷː	uvular, labial:affricate:+voice	\t{\textscg \textipa{K}}\super w\textlengthmark
ɢʁː	ɢ͡ʁː	uvular:affricate:+voice	\t{\textscg \textipa{K}}\textlengthmark
ɢʰ	ɢʰ	uvular:plosive:+voice +spread glottis	\textscg extsuperscript{h}
ɢʰː	ɢʰː	uvular:plosive:+voice +spread glottis	\textscg extsuperscript{h}\textlengthmark
ɢʲ	ɢʲ	uvular, palatal:plosive:+voice	\textscg\super j
ɢʲʰ	ɢʰʲ	uvular, palatal:plosive:+voice +spread glottis	\textscg extsuperscript{h}\super j
ɢʲʰː	ɢʰʲː	uvular, palatal:plosive:+voice +spread glottis	\textscg extsuperscript{h}\super j\textlengthmark
ɢʲː	ɢʲː	uvular, palatal:plosive:+voice	\textscg\super j\textlengthmark
ɢʷ	ɢʷ	uvular, labial:plosive:+voice	\textscg\super w
ɢʷʰ	ɢʰʷ	uvular, labial:plosive:+voice +spread glottis	\textscg extsuperscript{h}\super w
ɢʷʰː	ɢʰʷː	uvular, labial:plosive:+voice +spread glottis	\textscg extsuperscript{h}\super w\textlengthmark
ɢʷː	ɢʷː	uvular, labial:plosive:+voice	\textscg\super w\textlengthmark
ɢː	ɢː	uvular:plosive:+voice	\textscg\textlengthmark
ɢ̩	ɢ̩	uvular:plosive:+voice +syllabic	\textipa{\s{\textscg}}
ɢ̩ʲ	ɢ̩ʲ	uvular, palatal:plosive:+voice +syllabic	\textipa{\s{\textscg}}\super j
ɢ̩ʲː	ɢ̩ʲː	uvular, palatal:plosive:+voice +syllabic	\textipa{\s{\textscg}}\super j\textlengthmark
ɢ̩ʷ	ɢ̩ʷ	uvular, labial:plosive:+voice +syllabic	\textipa{\s{\textscg}}\super w
ɢ̩ʷː	ɢ̩ʷː	uvular, labial:plosive:+voice +syllabic	\textipa{\s{\textscg}}\super w\textlengthmark
ɢ̩ː	ɢ̩ː	uvular:plosive:+voice +syllabic	\textipa{\s{\textscg}}\textlengthmark
ɣ	ɣ	velar:fricative:+voice	\textipa{G}
ɣʲ	ɣʲ	velar, palatal:fricative:+voice	\textipa{G}\super j
ɣʲː	ɣʲː	velar, palatal:fricative:+voice	\textipa{G}\super j\textlengthmark
ɣʷ	ɣʷ	velar, labial:fricative:+voice	\textipa{G}\super w
ɣʷː	ɣʷː	velar, labial:fricative:+voice	\textipa{G}\super w\textlengthmark
ɣː	ɣː	velar:fricative:+voice	\textipa{G}\textlengthmark
ɣ̟	ɣ̟	velar:fricative:+voice	\begin{IPA}\|+G̟\end{IPA}
ɣ̟ʲ	ɣ̟ʲ	velar, palatal:fricative:+voice	\begin{IPA}\|+G̟\end{IPA}\super j
ɣ̟ʲː	ɣ̟ʲː	velar, palatal:fricative:+voice	\begin{IPA}\|+G̟\end{IPA}\super j\textlengthmark
ɣ̟ʷ	ɣ̟ʷ	velar, labial:fricative:+voice	\begin{IPA}\|+G̟\end{IPA}\super w
ɣ̟ʷː	ɣ̟ʷː	velar, labial:fricative:+voice	\begin{IPA}\|+G̟\end{IPA}\super w\textlengthmark
ɣ̟ː	ɣ̟ː	velar:fricative:+voice	\begin{IPA}\|+G̟\end{IPA}\textlengthmark
ɣ̠	ɣ̠	velar:fricative:+voice	\textsubbar{\textipa{G}}
ɣ̠ʲ	ɣ̠ʲ	velar, palatal:fricative:+voice	\textsubbar{\textipa{G}}\super j
ɣ̠ʲː	ɣ̠ʲː	velar, palatal:fricative:+voice	\textsubbar{\textipa{G}}\super j\textlengthmark
ɣ̠ʷ	ɣ̠ʷ	velar, labial:fricative:+voice	\textsubbar{\textipa{G}}\super w
ɣ̠ʷː	ɣ̠ʷː	velar, labial:fricative:+voice	\textsubbar{\textipa{G}}\super w\textlengthmark
ɣ̠ː	ɣ̠ː	velar:fricative:+voice	\textsubbar{\textipa{G}}\textlengthmark
ɣ̩	ɣ̩	velar:fricative:+voice +syllabic	\textipa{\sG}
ɣ̩ʲ	ɣ̩ʲ	velar, palatal:fricative:+voice +syllabic	\textipa{\sG}\super j
ɣ̩ʲː	ɣ̩ʲː	velar, palatal:fricative:+voice +syllabic	\textipa{\sG}\super j\textlengthmark
ɣ̩ʷ	ɣ̩ʷ	velar, labial:fricative:+voice +syllabic	\textipa{\sG}\super w
ɣ̩ʷː	ɣ̩ʷː	velar, labial:fricative:+voice +syllabic	\textipa{\sG}\super w\textlengthmark
ɣ̩ː	ɣ̩ː	velar:fricative:+voice +syllabic	\textipa{\sG}\textlengthmark
ɤ	ɤ	empty:vowel:−high −low +back −round +voice −nasal −spread glottis −constricted glottis	\textipa{7}
ɤː	ɤː	empty:vowel:−high −low +back −round +voice −nasal −spread glottis −constricted glottis	\textipa{7}\textlengthmark
ɤ̃	ɤ̃	empty:vowel:−high −low +back −round +voice +nasal −spread glottis −constricted glottis	\textipa{\~\textipa{7}}
ɤ̃ː	ɤ̃ː	empty:vowel:−high −low +back −round +voice +nasal −spread glottis −constricted glottis	\textipa{\~\textipa{7}}\textlengthmark
ɤ̥	ɤ̥	empty:vowel:−high −low +back −round −voice −nasal −spread glottis −constricted glottis	*\textipa{7}
ɤ̥ː	ɤ̥ː	empty:vowel:−high −low +back −round −voice −nasal −spread glottis −constricted glottis	*\textipa{7}\textlengthmark
ɤ̥̃	ɤ̥̃	empty:vowel:−high −low +back −round −voice +nasal −spread glottis −constricted glottis	*\textipa{\~\textipa{7}}
ɤ̥̃ː	ɤ̥̃ː	empty:vowel:−high −low +back −round −voice +nasal −spread glottis −constricted glottis	*\textipa{\~\textipa{7}}\textlengthmark
ɤ̥̯	ɤ̯̥	empty:vowel:−high −low +back −round −voice −nasal −spread glottis −constricted glottis	*\textroundcap{\textipa{7}}
ɤ̥̯ː	ɤ̯̥ː	empty:vowel:−high −low +back −round −voice −nasal −spread glottis −constricted glottis	*\textroundcap{\textipa{7}}\textlengthmark
ɤ̥̯̃	ɤ̯̥̃	empty:vowel:−high −low +back −round −voice +nasal −spread glottis −constricted glottis	*\textipa{\~\textroundcap{\textipa{7}}}
ɤ̥̯̃ː	ɤ̯̥̃ː	empty:vowel:−high −low +back −round −voice +nasal −spread glottis −constricted glottis	*\textipa{\~\textroundcap{\textipa{7}}}\textlengthmark
ɤ̯	ɤ̯	empty:vowel:−high −low +back −round +voice −nasal −spread glottis −constricted glottis	\textroundcap{\textipa{7}}
ɤ̯ː	ɤ̯ː	empty:vowel:−high −low +back −round +voice −nasal −spread glottis −constricted glottis	\textroundcap{\textipa{7}}\textlengthmark
ɤ̯̃	ɤ̯̃	empty:vowel:−high −low +back −round +voice +nasal −spread glottis −constricted glottis	\textipa{\~\textroundcap{\textipa{7}}}
ɤ̯̃ː	ɤ̯̃ː	empty:vowel:−high −low +back −round +voice +nasal −spread glottis −constricted glottis	\textipa{\~\textroundcap{\textipa{7}}}\textlengthmark
ɥ	ɥ	labial, palatal:glide:+voice	\textturnh
ɥ̃	ɥ̃	labial, palatal:glide:+voice +nasal	\textipa{\~\textturnh}
ɦ	ɦ	glottal:fricative:+voice	\texthth
ɦʲ	ɦʲ	glottal, palatal:fricative:+voice	\texthth\super j
ɦʲː	ɦʲː	glottal, palatal:fricative:+voice	\texthth\super j\textlengthmark
ɦʷ	ɦʷ	glottal, labial:fricative:+voice	\texthth\super w
ɦʷː	ɦʷː	glottal, labial:fricative:+voice	\texthth\super w\textlengthmark
ɦː	ɦː	glottal:fricative:+voice	\texthth\textlengthmark
ɦ̩	ɦ̩	glottal:fricative:+voice +syllabic	\textipa{\s{\texthth}}
ɦ̩ʲ	ɦ̩ʲ	glottal, palatal:fricative:+voice +syllabic	\textipa{\s{\texthth}}\super j
ɦ̩ʲː	ɦ̩ʲː	glottal, palatal:fricative:+voice +syllabic	\textipa{\s{\texthth}}\super j\textlengthmark
ɦ̩ʷ	ɦ̩ʷ	glottal, labial:fricative:+voice +syllabic	\textipa{\s{\texthth}}\super w
ɦ̩ʷː	ɦ̩ʷː	glottal, labial:fricative:+voice +syllabic	\textipa{\s{\texthth}}\super w\textlengthmark
ɦ̩ː	ɦ̩ː	glottal:fricative:+voice +syllabic	\textipa{\s{\texthth}}\textlengthmark
ɧ	ɧ	palatoalveolar, velar:fricative:−voice	\texththeng
ɧʲ	ɧʲ	palatoalveolar, velar, palatal:fricative:−voice	\texththeng\super j
ɧʲː	ɧʲː	palatoalveolar, velar, palatal:fricative:−voice	\texththeng\super j\textlengthmark
ɧʷ	ɧʷ	palatoalveolar, velar, labial:fricative:−voice	\texththeng\super w
ɧʷː	ɧʷː	palatoalveolar, velar, labial:fricative:−voice	\texththeng\super w\textlengthmark
ɧː	ɧː	palatoalveolar, velar:fricative:−voice	\texththeng\textlengthmark
ɧ̩	ɧ̩	palatoalveolar, velar:fricative:−voice +syllabic	\textipa{\s{\texththeng}}
ɧ̩ʲ	ɧ̩ʲ	palatoalveolar, velar, palatal:fricative:−voice +syllabic	\textipa{\s{\texththeng}}\super j
ɧ̩ʲː	ɧ̩ʲː	palatoalveolar, velar, palatal:fricative:−voice +syllabic	\textipa{\s{\texththeng}}\super j\textlengthmark
ɧ̩ʷ	ɧ̩ʷ	palatoalveolar, velar, labial:fricative:−voice +syllabic	\textipa{\s{\texththeng}}\super w
ɧ̩ʷː	ɧ̩ʷː	palatoalveolar, velar, labial:fricative:−voice +syllabic	\textipa{\s{\texththeng}}\super w\textlengthmark
ɧ̩ː	ɧ̩ː	palatoalveolar, velar:fricative:−voice +syllabic	\textipa{\s{\texththeng}}\textlengthmark
ɨ	ɨ	empty:vowel:+high −low +back −round +voice −nasal −spread glottis −constricted glottis	\textbari
ɨː	ɨː	empty:vowel:+high −low +back −round +voice −nasal −spread glottis −constricted glottis	\textbari\textlengthmark
ɨ̃	ɨ̃	empty:vowel:+high −low +back −round +voice +nasal −spread glottis −constricted glottis	\textipa{\~\textbari}
ɨ̃ː	ɨ̃ː	empty:vowel:+high −low +back −round +voice +nasal −spread glottis −constricted glottis	\textipa{\~\textbari}\textlengthmark
ɨ̥	ɨ̥	empty:vowel:+high −low +back −round −voice −nasal −spread glottis −constricted glottis	*\textbari
ɨ̥ː	ɨ̥ː	empty:vowel:+high −low +back −round −voice −nasal −spread glottis −constricted glottis	*\textbari\textlengthmark
ɨ̥̃	ɨ̥̃	empty:vowel:+high −low +back −round −voice +nasal −spread glottis −constricted glottis	*\textipa{\~\textbari}
ɨ̥̃ː	ɨ̥̃ː	empty:vowel:+high −low +back −round −voice +nasal −spread glottis −constricted glottis	*\textipa{\~\textbari}\textlengthmark
ɨ̥̯	ɨ̯̥	empty:vowel:+high −low +back −round −voice −nasal −spread glottis −constricted glottis	*\textroundcap{\textbari}
ɨ̥̯ː	ɨ̯̥ː	empty:vowel:+high −low +back −round −voice −nasal −spread glottis −constricted glottis	*\textroundcap{\textbari}\textlengthmark
ɨ̥̯̃	ɨ̯̥̃	empty:vowel:+high −low +back −round −voice +nasal −spread glottis −constricted glottis	*\textipa{\~\textroundcap{\textbari}}
ɨ̥̯̃ː	ɨ̯̥̃ː	empty:vowel:+high −low +back −round −voice +nasal −spread glottis −constricted glottis	*\textipa{\~\textroundcap{\textbari}}\textlengthmark
ɨ̯	ɨ̯	empty:vowel:+high −low +back −round +voice −nasal −spread glottis −constricted glottis	\textroundcap{\textbari}
ɨ̯ː	ɨ̯ː	empty:vowel:+high −low +back −round +voice −nasal −spread glottis −constricted glottis	\textroundcap{\textbari}\textlengthmark
ɨ̯̃	ɨ̯̃	empty:vowel:+high −low +back −round +voice +nasal −spread glottis −constricted glottis	\textipa{\~\textroundcap{\textbari}}
ɨ̯̃ː	ɨ̯̃ː	empty:vowel:+high −low +back −round +voice +nasal −spread glottis −constricted glottis	\textipa{\~\textroundcap{\textbari}}\textlengthmark
ɪ	ɪ	empty:vowel:+high −low −back −round +voice −nasal −spread glottis −constricted glottis	\textipa{I}
ɪː	ɪː	empty:vowel:+high −low −back −round +voice −nasal −spread glottis −constricted glottis	\textipa{I}\textlengthmark
ɪ̃	ɪ̃	empty:vowel:+high −low −back −round +voice +nasal −spread glottis −constricted glottis	\textipa{\~\textipa{I}}
ɪ̃ː	ɪ̃ː	empty:vowel:+high −low −back −round +voice +nasal −spread glottis −constricted glottis	\textipa{\~\textipa{I}}\textlengthmark
ɪ̥	ɪ̥	empty:vowel:+high −low −back −round −voice −nasal −spread glottis −constricted glottis	*\textipa{I}
ɪ̥ː	ɪ̥ː	empty:vowel:+high −low −back −round −voice −nasal −spread glottis −constricted glottis	*\textipa{I}\textlengthmark
ɪ̥̃	ɪ̥̃	empty:vowel:+high −low −back −round −voice +nasal −spread glottis −constricted glottis	*\textipa{\~\textipa{I}}
ɪ̥̃ː	ɪ̥̃ː	empty:vowel:+high −low −back −round −voice +nasal −spread glottis −constricted glottis	*\textipa{\~\textipa{I}}\textlengthmark
ɪ̥̯	ɪ̯̥	empty:vowel:+high −low −back −round −voice −nasal −spread glottis −constricted glottis	*\textroundcap{\textipa{I}}
ɪ̥̯ː	ɪ̯̥ː	empty:vowel:+high −low −back −round −voice −nasal −spread glottis −constricted glottis	*\textroundcap{\textipa{I}}\textlengthmark
ɪ̥̯̃	ɪ̯̥̃	empty:vowel:+high −low −back −round −voice +nasal −spread glottis −constricted glottis	*\textipa{\~\textroundcap{\textipa{I}}}
ɪ̥̯̃ː	ɪ̯̥̃ː	empty:vowel:+high −low −back −round −voice +nasal −spread glottis −constricted glottis	*\textipa{\~\textroundcap{\textipa{I}}}\textlengthmark
ɪ̯	ɪ̯	empty:vowel:+high −low −back −round +voice −nasal −spread glottis −constricted glottis	\textroundcap{\textipa{I}}
ɪ̯ː	ɪ̯ː	empty:vowel:+high −low −back −round +voice −nasal −spread glottis −constricted glottis	\textroundcap{\textipa{I}}\textlengthmark
ɪ̯̃	ɪ̯̃	empty:vowel:+high −low −back −round +voice +nasal −spread glottis −constricted glottis	\textipa{\~\textroundcap{\textipa{I}}}
ɪ̯̃ː	ɪ̯̃ː	empty:vowel:+high −low −back −round +voice +nasal −spread glottis −constricted glottis	\textipa{\~\textroundcap{\textipa{I}}}\textlengthmark
ɬ	ɬ	alveolar:fricative:+voice +lateral	\textbeltl
ɬʲ	ɬʲ	alveolar, palatal:fricative:+voice +lateral	\textbeltl\super j
ɬʲː	ɬʲː	alveolar, palatal:fricative:+voice +lateral	\textbeltl\super j\textlengthmark
ɬʷ	ɬʷ	alveolar, labial:fricative:+voice +lateral	\textbeltl\super w
ɬʷː	ɬʷː	alveolar, labial:fricative:+voice +lateral	\textbeltl\super w\textlengthmark
ɬː	ɬː	alveolar:fricative:+voice +lateral	\textbeltl\textlengthmark
ɬ̠	ɬ̠	alveolar:fricative:+voice +lateral	\textsubbar{\textbeltl}
ɬ̠ʲ	ɬ̠ʲ	alveolar, palatal:fricative:+voice +lateral	\textsubbar{\textbeltl}\super j
ɬ̠ʲː	ɬ̠ʲː	alveolar, palatal:fricative:+voice +lateral	\textsubbar{\textbeltl}\super j\textlengthmark
ɬ̠ʷ	ɬ̠ʷ	alveolar, labial:fricative:+voice +lateral	\textsubbar{\textbeltl}\super w
ɬ̠ʷː	ɬ̠ʷː	alveolar, labial:fricative:+voice +lateral	\textsubbar{\textbeltl}\super w\textlengthmark
ɬ̠ː	ɬ̠ː	alveolar:fricative:+voice +lateral	\textsubbar{\textbeltl}\textlengthmark
ɬ̩	ɬ̩	alveolar:fricative:+voice +lateral +syllabic	\textipa{\s{\textbeltl}}
ɬ̩ʲ	ɬ̩ʲ	alveolar, palatal:fricative:+voice +lateral +syllabic	\textipa{\s{\textbeltl}}\super j
ɬ̩ʲː	ɬ̩ʲː	alveolar, palatal:fricative:+voice +lateral +syllabic	\textipa{\s{\textbeltl}}\super j\textlengthmark
ɬ̩ʷ	ɬ̩ʷ	alveolar, labial:fricative:+voice +lateral +syllabic	\textipa{\s{\textbeltl}}\super w
ɬ̩ʷː	ɬ̩ʷː	alveolar, labial:fricative:+voice +lateral +syllabic	\textipa{\s{\textbeltl}}\super w\textlengthmark
ɬ̩ː	ɬ̩ː	alveolar:fricative:+voice +lateral +syllabic	\textipa{\s{\textbeltl}}\textlengthmark
ɬ̪	ɬ̪	dental:fricative:+voice +lateral	\textsubbridge{\textbeltl}
ɬ̪ʲ	ɬ̪ʲ	dental, palatal:fricative:+voice +lateral	\textsubbridge{\textbeltl}\super j
ɬ̪ʲː	ɬ̪ʲː	dental, palatal:fricative:+voice +lateral	\textsubbridge{\textbeltl}\super j\textlengthmark
ɬ̪ʷ	ɬ̪ʷ	dental, labial:fricative:+voice +lateral	\textsubbridge{\textbeltl}\super w
ɬ̪ʷː	ɬ̪ʷː	dental, labial:fricative:+voice +lateral	\textsubbridge{\textbeltl}\super w\textlengthmark
ɬ̪ː	ɬ̪ː	dental:fricative:+voice +lateral	\textsubbridge{\textbeltl}\textlengthmark
ɭ	ɭ	retroflex:liquid:+voice +lateral	\textturny
ɭʲ	ɭʲ	retroflex, palatal:liquid:+voice +lateral	\textturny\super j
ɭ̥	ɭ̥	retroflex:liquid:−voice +lateral	*\textturny
ɭ̥ʲ	ɭ̥ʲ	retroflex, palatal:liquid:−voice +lateral	*\textturny\super j
ɭ̩	ɭ̩	retroflex:liquid:+voice +lateral +syllabic	\textipa{\s{\textturny}}
ɭ̩̥	ɭ̥̩	retroflex:liquid:−voice +lateral +syllabic	\textipa{\s{ *\textturny}}
ɮ	ɮ	alveolar:fricative:+voice +lateral	\textlyoghlig
ɮʲ	ɮʲ	alveolar, palatal:fricative:+voice +lateral	\textlyoghlig\super j
ɮʲː	ɮʲː	alveolar, palatal:fricative:+voice +lateral	\textlyoghlig\super j\textlengthmark
ɮʷ	ɮʷ	alveolar, labial:fricative:+voice +lateral	\textlyoghlig\super w
ɮʷː	ɮʷː	alveolar, labial:fricative:+voice +lateral	\textlyoghlig\super w\textlengthmark
ɮː	ɮː	alveolar:fricative:+voice +lateral	\textlyoghlig\textlengthmark
ɮ̠	ɮ̠	alveolar:fricative:+voice +lateral	\textsubbar{\textlyoghlig}
ɮ̠ʲ	ɮ̠ʲ	alveolar, palatal:fricative:+voice +lateral	\textsubbar{\textlyoghlig}\super j
ɮ̠ʲː	ɮ̠ʲː	alveolar, palatal:fricative:+voice +lateral	\textsubbar{\textlyoghlig}\super j\textlengthmark
ɮ̠ʷ	ɮ̠ʷ	alveolar, labial:fricative:+voice +lateral	\textsubbar{\textlyoghlig}\super w
ɮ̠ʷː	ɮ̠ʷː	alveolar, labial:fricative:+voice +lateral	\textsubbar{\textlyoghlig}\super w\textlengthmark
ɮ̠ː	ɮ̠ː	alveolar:fricative:+voice +lateral	\textsubbar{\textlyoghlig}\textlengthmark
ɮ̩	ɮ̩	alveolar:fricative:+voice +lateral +syllabic	\textipa{\s{\textlyoghlig}}
ɮ̩ʲ	ɮ̩ʲ	alveolar, palatal:fricative:+voice +lateral +syllabic	\textipa{\s{\textlyoghlig}}\super j
ɮ̩ʲː	ɮ̩ʲː	alveolar, palatal:fricative:+voice +lateral +syllabic	\textipa{\s{\textlyoghlig}}\super j\textlengthmark
ɮ̩ʷ	ɮ̩ʷ	alveolar, labial:fricative:+voice +lateral +syllabic	\textipa{\s{\textlyoghlig}}\super w
ɮ̩ʷː	ɮ̩ʷː	alveolar, labial:fricative:+voice +lateral +syllabic	\textipa{\s{\textlyoghlig}}\super w\textlengthmark
ɮ̩ː	ɮ̩ː	alveolar:fricative:+voice +lateral +syllabic	\textipa{\s{\textlyoghlig}}\textlengthmark
ɮ̪	ɮ̪	dental:fricative:+voice +lateral	\textsubbridge{\textlyoghlig}
ɮ̪ʲ	ɮ̪ʲ	dental, palatal:fricative:+voice +lateral	\textsubbridge{\textlyoghlig}\super j
ɮ̪ʲː	ɮ̪ʲː	dental, palatal:fricative:+voice +lateral	\textsubbridge{\textlyoghlig}\super j\textlengthmark
ɮ̪ʷ	ɮ̪ʷ	dental, labial:fricative:+voice +lateral	\textsubbridge{\textlyoghlig}\super w
ɮ̪ʷː	ɮ̪ʷː	dental, labial:fricative:+voice +lateral	\textsubbridge{\textlyoghlig}\super w\textlengthmark
ɮ̪ː	ɮ̪ː	dental:fricative:+voice +lateral	\textsubbridge{\textlyoghlig}\textlengthmark
ɯ	ɯ	empty:vowel:+high −low +back +round +voice −nasal −spread glottis −constricted glottis	\textturnm
ɯː	ɯː	empty:vowel:+high −low +back +round +voice −nasal −spread glottis −constricted glottis	\textturnm\textlengthmark
ɯ̃	ɯ̃	empty:vowel:+high −low +back +round +voice +nasal −spread glottis −constricted glottis	\textipa{\~\textturnm}
ɯ̃ː	ɯ̃ː	empty:vowel:+high −low +back +round +voice +nasal −spread glottis −constricted glottis	\textipa{\~\textturnm}\textlengthmark
ɯ̥	ɯ̥	empty:vowel:+high −low +back +round −voice −nasal −spread glottis −constricted glottis	*\textturnm
ɯ̥ː	ɯ̥ː	empty:vowel:+high −low +back +round −voice −nasal −spread glottis −constricted glottis	*\textturnm\textlengthmark
ɯ̥̃	ɯ̥̃	empty:vowel:+high −low +back +round −voice +nasal −spread glottis −constricted glottis	*\textipa{\~\textturnm}
ɯ̥̃ː	ɯ̥̃ː	empty:vowel:+high −low +back +round −voice +nasal −spread glottis −constricted glottis	*\textipa{\~\textturnm}\textlengthmark
ɯ̥̯	ɯ̯̥	empty:vowel:+high −low +back +round −voice −nasal −spread glottis −constricted glottis	*\textroundcap{\textturnm}
ɯ̥̯ː	ɯ̯̥ː	empty:vowel:+high −low +back +round −voice −nasal −spread glottis −constricted glottis	*\textroundcap{\textturnm}\textlengthmark
ɯ̥̯̃	ɯ̯̥̃	empty:vowel:+high −low +back +round −voice +nasal −spread glottis −constricted glottis	*\textipa{\~\textroundcap{\textturnm}}
ɯ̥̯̃ː	ɯ̯̥̃ː	empty:vowel:+high −low +back +round −voice +nasal −spread glottis −constricted glottis	*\textipa{\~\textroundcap{\textturnm}}\textlengthmark
ɯ̯	ɯ̯	empty:vowel:+high −low +back +round +voice −nasal −spread glottis −constricted glottis	\textroundcap{\textturnm}
ɯ̯ː	ɯ̯ː	empty:vowel:+high −low +back +round +voice −nasal −spread glottis −constricted glottis	\textroundcap{\textturnm}\textlengthmark
ɯ̯̃	ɯ̯̃	empty:vowel:+high −low +back +round +voice +nasal −spread glottis −constricted glottis	\textipa{\~\textroundcap{\textturnm}}
ɯ̯̃ː	ɯ̯̃ː	empty:vowel:+high −low +back +round +voice +nasal −spread glottis −constricted glottis	\textipa{\~\textroundcap{\textturnm}}\textlengthmark
ɰ	ɰ	velar:glide:+voice	\textturnmrleg
ɰ̃	ɰ̃	velar:glide:+voice +nasal	\textipa{\~\textturnmrleg}
ɰ̠	ɰ̠	velar:glide:+voice	\textsubbar{\textturnmrleg}
ɱ	ɱ	labiodental:nasal:+voice +nasal	\textltailm
ɱʰ	ɱʰ	labiodental:nasal:+voice +nasal +spread glottis	\textltailm extsuperscript{h}
ɱʰː	ɱʰː	labiodental:nasal:+voice +nasal +spread glottis	\textltailm extsuperscript{h}\textlengthmark
ɱʲ	ɱʲ	labiodental, palatal:nasal:+voice +nasal	\textltailm\super j
ɱʲʰ	ɱʰʲ	labiodental, palatal:nasal:+voice +nasal +spread glottis	\textltailm extsuperscript{h}\super j
ɱʲʰː	ɱʰʲː	labiodental, palatal:nasal:+voice +nasal +spread glottis	\textltailm extsuperscript{h}\super j\textlengthmark
ɱʲː	ɱʲː	labiodental, palatal:nasal:+voice +nasal	\textltailm\super j\textlengthmark
ɱʷ	ɱʷ	labiodental, labial:nasal:+voice +nasal	\textltailm\super w
ɱʷʰ	ɱʰʷ	labiodental, labial:nasal:+voice +nasal +spread glottis	\textltailm extsuperscript{h}\super w
ɱʷʰː	ɱʰʷː	labiodental, labial:nasal:+voice +nasal +spread glottis	\textltailm extsuperscript{h}\super w\textlengthmark
ɱʷː	ɱʷː	labiodental, labial:nasal:+voice +nasal	\textltailm\super w\textlengthmark
ɱː	ɱː	labiodental:nasal:+voice +nasal	\textltailm\textlengthmark
ɱ̊	ɱ̥	labiodental:nasal:−voice +nasal	*\textltailm
ɱ̥ʰ	ɱ̥ʰ	labiodental:nasal:−voice +nasal +spread glottis	*\textltailm extsuperscript{h}
ɱ̥ʰː	ɱ̥ʰː	labiodental:nasal:−voice +nasal +spread glottis	*\textltailm extsuperscript{h}\textlengthmark
ɱ̥ʲ	ɱ̥ʲ	labiodental, palatal:nasal:−voice +nasal	*\textltailm\super j
ɱ̥ʲʰ	ɱ̥ʰʲ	labiodental, palatal:nasal:−voice +nasal +spread glottis	*\textltailm extsuperscript{h}\super j
ɱ̥ʲʰː	ɱ̥ʰʲː	labiodental, palatal:nasal:−voice +nasal +spread glottis	*\textltailm extsuperscript{h}\super j\textlengthmark
ɱ̥ʲː	ɱ̥ʲː	labiodental, palatal:nasal:−voice +nasal	*\textltailm\super j\textlengthmark
ɱ̥ʷ	ɱ̥ʷ	labiodental, labial:nasal:−voice +nasal	*\textltailm\super w
ɱ̥ʷʰ	ɱ̥ʰʷ	labiodental, labial:nasal:−voice +nasal +spread glottis	*\textltailm extsuperscript{h}\super w
ɱ̥ʷʰː	ɱ̥ʰʷː	labiodental, labial:nasal:−voice +nasal +spread glottis	*\textltailm extsuperscript{h}\super w\textlengthmark
ɱ̥ʷː	ɱ̥ʷː	labiodental, labial:nasal:−voice +nasal	*\textltailm\super w\textlengthmark
ɱ̥ː	ɱ̥ː	labiodental:nasal:−voice +nasal	*\textltailm\textlengthmark
ɱ̩	ɱ̩	labiodental:nasal:+voice +nasal +syllabic	\textipa{\s{\textltailm}}
ɱ̩ʲ	ɱ̩ʲ	labiodental, palatal:nasal:+voice +nasal +syllabic	\textipa{\s{\textltailm}}\super j
ɱ̩ʲː	ɱ̩ʲː	labiodental, palatal:nasal:+voice +nasal +syllabic	\textipa{\s{\textltailm}}\super j\textlengthmark
ɱ̩ʷ	ɱ̩ʷ	labiodental, labial:nasal:+voice +nasal +syllabic	\textipa{\s{\textltailm}}\super w
ɱ̩ʷː	ɱ̩ʷː	labiodental, labial:nasal:+voice +nasal +syllabic	\textipa{\s{\textltailm}}\super w\textlengthmark
ɱ̩ː	ɱ̩ː	labiodental:nasal:+voice +nasal +syllabic	\textipa{\s{\textltailm}}\textlengthmark
ɱ̩̥	ɱ̥̩	labiodental:nasal:−voice +nasal +syllabic	\textipa{\s{ *\textltailm}}
ɱ̩̥ʲ	ɱ̥̩ʲ	labiodental, palatal:nasal:−voice +nasal +syllabic	\textipa{\s{ *\textltailm}}\super j
ɱ̩̥ʲː	ɱ̥̩ʲː	labiodental, palatal:nasal:−voice +nasal +syllabic	\textipa{\s{ *\textltailm}}\super j\textlengthmark
ɱ̩̥ʷ	ɱ̥̩ʷ	labiodental, labial:nasal:−voice +nasal +syllabic	\textipa{\s{ *\textltailm}}\super w
ɱ̩̥ʷː	ɱ̥̩ʷː	labiodental, labial:nasal:−voice +nasal +syllabic	\textipa{\s{ *\textltailm}}\super w\textlengthmark
ɱ̩̥ː	ɱ̥̩ː	labiodental:nasal:−voice +nasal +syllabic	\textipa{\s{ *\textltailm}}\textlengthmark
ɲ	ɲ	palatal:nasal:+voice +nasal	\textltailn
ɲʰ	ɲʰ	palatal:nasal:+voice +nasal +spread glottis	\textltailn extsuperscript{h}
ɲʰː	ɲʰː	palatal:nasal:+voice +nasal +spread glottis	\textltailn extsuperscript{h}\textlengthmark
ɲʲ	ɲʲ	palatal:nasal:+voice +nasal	\textltailn\super j
ɲʲʰ	ɲʰʲ	palatal:nasal:+voice +nasal +spread glottis	\textltailn extsuperscript{h}\super j
ɲʲʰː	ɲʰʲː	palatal:nasal:+voice +nasal +spread glottis	\textltailn extsuperscript{h}\super j\textlengthmark
ɲʲː	ɲʲː	palatal:nasal:+voice +nasal	\textltailn\super j\textlengthmark
ɲʷ	ɲʷ	palatal, labial:nasal:+voice +nasal	\textltailn\super w
ɲʷʰ	ɲʰʷ	palatal, labial:nasal:+voice +nasal +spread glottis	\textltailn extsuperscript{h}\super w
ɲʷʰː	ɲʰʷː	palatal, labial:nasal:+voice +nasal +spread glottis	\textltailn extsuperscript{h}\super w\textlengthmark
ɲʷː	ɲʷː	palatal, labial:nasal:+voice +nasal	\textltailn\super w\textlengthmark
ɲː	ɲː	palatal:nasal:+voice +nasal	\textltailn\textlengthmark
ɲ̊	ɲ̥	palatal:nasal:−voice +nasal	*\textltailn
ɲ̥ʰ	ɲ̥ʰ	palatal:nasal:−voice +nasal +spread glottis	*\textltailn extsuperscript{h}
ɲ̥ʰː	ɲ̥ʰː	palatal:nasal:−voice +nasal +spread glottis	*\textltailn extsuperscript{h}\textlengthmark
ɲ̥ʲ	ɲ̥ʲ	palatal:nasal:−voice +nasal	*\textltailn\super j
ɲ̥ʲʰ	ɲ̥ʰʲ	palatal:nasal:−voice +nasal +spread glottis	*\textltailn extsuperscript{h}\super j
ɲ̥ʲʰː	ɲ̥ʰʲː	palatal:nasal:−voice +nasal +spread glottis	*\textltailn extsuperscript{h}\super j\textlengthmark
ɲ̥ʲː	ɲ̥ʲː	palatal:nasal:−voice +nasal	*\textltailn\super j\textlengthmark
ɲ̥ʷ	ɲ̥ʷ	palatal, labial:nasal:−voice +nasal	*\textltailn\super w
ɲ̥ʷʰ	ɲ̥ʰʷ	palatal, labial:nasal:−voice +nasal +spread glottis	*\textltailn extsuperscript{h}\super w
ɲ̥ʷʰː	ɲ̥ʰʷː	palatal, labial:nasal:−voice +nasal +spread glottis	*\textltailn extsuperscript{h}\super w\textlengthmark
ɲ̥ʷː	ɲ̥ʷː	palatal, labial:nasal:−voice +nasal	*\textltailn\super w\textlengthmark
ɲ̥ː	ɲ̥ː	palatal:nasal:−voice +nasal	*\textltailn\textlengthmark
ɲ̩	ɲ̩	palatal:nasal:+voice +nasal +syllabic	\textipa{\s{\textltailn}}
ɲ̩ʲ	ɲ̩ʲ	palatal:nasal:+voice +nasal +syllabic	\textipa{\s{\textltailn}}\super j
ɲ̩ʲː	ɲ̩ʲː	palatal:nasal:+voice +nasal +syllabic	\textipa{\s{\textltailn}}\super j\textlengthmark
ɲ̩ʷ	ɲ̩ʷ	palatal, labial:nasal:+voice +nasal +syllabic	\textipa{\s{\textltailn}}\super w
ɲ̩ʷː	ɲ̩ʷː	palatal, labial:nasal:+voice +nasal +syllabic	\textipa{\s{\textltailn}}\super w\textlengthmark
ɲ̩ː	ɲ̩ː	palatal:nasal:+voice +nasal +syllabic	\textipa{\s{\textltailn}}\textlengthmark
ɲ̩̥	ɲ̥̩	palatal:nasal:−voice +nasal +syllabic	\textipa{\s{ *\textltailn}}
ɲ̩̥ʲ	ɲ̥̩ʲ	palatal:nasal:−voice +nasal +syllabic	\textipa{\s{ *\textltailn}}\super j
ɲ̩̥ʲː	ɲ̥̩ʲː	palatal:nasal:−voice +nasal +syllabic	\textipa{\s{ *\textltailn}}\super j\textlengthmark
ɲ̩̥ʷ	ɲ̥̩ʷ	palatal, labial:nasal:−voice +nasal +syllabic	\textipa{\s{ *\textltailn}}\super w
ɲ̩̥ʷː	ɲ̥̩ʷː	palatal, labial:nasal:−voice +nasal +syllabic	\textipa{\s{ *\textltailn}}\super w\textlengthmark
ɲ̩̥ː	ɲ̥̩ː	palatal:nasal:−voice +nasal +syllabic	\textipa{\s{ *\textltailn}}\textlengthmark
ɳ	ɳ	retroflex:nasal:+voice +nasal	\:n
ɳʰ	ɳʰ	retroflex:nasal:+voice +nasal +spread glottis	\:n extsuperscript{h}
ɳʰː	ɳʰː	retroflex:nasal:+voice +nasal +spread glottis	\:n extsuperscript{h}\textlengthmark
ɳʲ	ɳʲ	retroflex, palatal:nasal:+voice +nasal	\:n\super j
ɳʲʰ	ɳʰʲ	retroflex, palatal:nasal:+voice +nasal +spread glottis	\:n extsuperscript{h}\super j
ɳʲʰː	ɳʰʲː	retroflex, palatal:nasal:+voice +nasal +spread glottis	\:n extsuperscript{h}\super j\textlengthmark
ɳʲː	ɳʲː	retroflex, palatal:nasal:+voice +nasal	\:n\super j\textlengthmark
ɳʷ	ɳʷ	retroflex, labial:nasal:+voice +nasal	\:n\super w
ɳʷʰ	ɳʰʷ	retroflex, labial:nasal:+voice +nasal +spread glottis	\:n extsuperscript{h}\super w
ɳʷʰː	ɳʰʷː	retroflex, labial:nasal:+voice +nasal +spread glottis	\:n extsuperscript{h}\super w\textlengthmark
ɳʷː	ɳʷː	retroflex, labial:nasal:+voice +nasal	\:n\super w\textlengthmark
ɳː	ɳː	retroflex:nasal:+voice +nasal	\:n\textlengthmark
ɳ̥	ɳ̥	retroflex:nasal:−voice +nasal	*\:n
ɳ̥ʰ	ɳ̥ʰ	retroflex:nasal:−voice +nasal +spread glottis	*\:n extsuperscript{h}
ɳ̥ʰː	ɳ̥ʰː	retroflex:nasal:−voice +nasal +spread glottis	*\:n extsuperscript{h}\textlengthmark
ɳ̥ʲ	ɳ̥ʲ	retroflex, palatal:nasal:−voice +nasal	*\:n\super j
ɳ̥ʲʰ	ɳ̥ʰʲ	retroflex, palatal:nasal:−voice +nasal +spread glottis	*\:n extsuperscript{h}\super j
ɳ̥ʲʰː	ɳ̥ʰʲː	retroflex, palatal:nasal:−voice +nasal +spread glottis	*\:n extsuperscript{h}\super j\textlengthmark
ɳ̥ʲː	ɳ̥ʲː	retroflex, palatal:nasal:−voice +nasal	*\:n\super j\textlengthmark
ɳ̥ʷ	ɳ̥ʷ	retroflex, labial:nasal:−voice +nasal	*\:n\super w
ɳ̥ʷʰ	ɳ̥ʰʷ	retroflex, labial:nasal:−voice +nasal +spread glottis	*\:n extsuperscript{h}\super w
ɳ̥ʷʰː	ɳ̥ʰʷː	retroflex, labial:nasal:−voice +nasal +spread glottis	*\:n extsuperscript{h}\super w\textlengthmark
ɳ̥ʷː	ɳ̥ʷː	retroflex, labial:nasal:−voice +nasal	*\:n\super w\textlengthmark
ɳ̥ː	ɳ̥ː	retroflex:nasal:−voice +nasal	*\:n\textlengthmark
ɳ̩	ɳ̩	retroflex:nasal:+voice +nasal +syllabic	\textipa{\s{\:n}}
ɳ̩ʲ	ɳ̩ʲ	retroflex, palatal:nasal:+voice +nasal +syllabic	\textipa{\s{\:n}}\super j
ɳ̩ʲː	ɳ̩ʲː	retroflex, palatal:nasal:+voice +nasal +syllabic	\textipa{\s{\:n}}\super j\textlengthmark
ɳ̩ʷ	ɳ̩ʷ	retroflex, labial:nasal:+voice +nasal +syllabic	\textipa{\s{\:n}}\super w
ɳ̩ʷː	ɳ̩ʷː	retroflex, labial:nasal:+voice +nasal +syllabic	\textipa{\s{\:n}}\super w\textlengthmark
ɳ̩ː	ɳ̩ː	retroflex:nasal:+voice +nasal +syllabic	\textipa{\s{\:n}}\textlengthmark
ɳ̩̥	ɳ̥̩	retroflex:nasal:−voice +nasal +syllabic	\textipa{\s{ *\:n}}
ɳ̩̥ʲ	ɳ̥̩ʲ	retroflex, palatal:nasal:−voice +nasal +syllabic	\textipa{\s{ *\:n}}\super j
ɳ̩̥ʲː	ɳ̥̩ʲː	retroflex, palatal:nasal:−voice +nasal +syllabic	\textipa{\s{ *\:n}}\super j\textlengthmark
ɳ̩̥ʷ	ɳ̥̩ʷ	retroflex, labial:nasal:−voice +nasal +syllabic	\textipa{\s{ *\:n}}\super w
ɳ̩̥ʷː	ɳ̥̩ʷː	retroflex, labial:nasal:−voice +nasal +syllabic	\textipa{\s{ *\:n}}\super w\textlengthmark
ɳ̩̥ː	ɳ̥̩ː	retroflex:nasal:−voice +nasal +syllabic	\textipa{\s{ *\:n}}\textlengthmark
ɴ	ɴ	uvular:nasal:+voice +nasal	\textscn
ɴʰ	ɴʰ	uvular:nasal:+voice +nasal +spread glottis	\textscn extsuperscript{h}
ɴʰː	ɴʰː	uvular:nasal:+voice +nasal +spread glottis	\textscn extsuperscript{h}\textlengthmark
ɴʲ	ɴʲ	uvular, palatal:nasal:+voice +nasal	\textscn\super j
ɴʲʰ	ɴʰʲ	uvular, palatal:nasal:+voice +nasal +spread glottis	\textscn extsuperscript{h}\super j
ɴʲʰː	ɴʰʲː	uvular, palatal:nasal:+voice +nasal +spread glottis	\textscn extsuperscript{h}\super j\textlengthmark
ɴʲː	ɴʲː	uvular, palatal:nasal:+voice +nasal	\textscn\super j\textlengthmark
ɴʷ	ɴʷ	uvular, labial:nasal:+voice +nasal	\textscn\super w
ɴʷʰ	ɴʰʷ	uvular, labial:nasal:+voice +nasal +spread glottis	\textscn extsuperscript{h}\super w
ɴʷʰː	ɴʰʷː	uvular, labial:nasal:+voice +nasal +spread glottis	\textscn extsuperscript{h}\super w\textlengthmark
ɴʷː	ɴʷː	uvular, labial:nasal:+voice +nasal	\textscn\super w\textlengthmark
ɴː	ɴː	uvular:nasal:+voice +nasal	\textscn\textlengthmark
ɴ̥	ɴ̥	uvular:nasal:−voice +nasal	*\textscn
ɴ̥ʰ	ɴ̥ʰ	uvular:nasal:−voice +nasal +spread glottis	*\textscn extsuperscript{h}
ɴ̥ʰː	ɴ̥ʰː	uvular:nasal:−voice +nasal +spread glottis	*\textscn extsuperscript{h}\textlengthmark
ɴ̥ʲ	ɴ̥ʲ	uvular, palatal:nasal:−voice +nasal	*\textscn\super j
ɴ̥ʲʰ	ɴ̥ʰʲ	uvular, palatal:nasal:−voice +nasal +spread glottis	*\textscn extsuperscript{h}\super j
ɴ̥ʲʰː	ɴ̥ʰʲː	uvular, palatal:nasal:−voice +nasal +spread glottis	*\textscn extsuperscript{h}\super j\textlengthmark
ɴ̥ʲː	ɴ̥ʲː	uvular, palatal:nasal:−voice +nasal	*\textscn\super j\textlengthmark
ɴ̥ʷ	ɴ̥ʷ	uvular, labial:nasal:−voice +nasal	*\textscn\super w
ɴ̥ʷʰ	ɴ̥ʰʷ	uvular, labial:nasal:−voice +nasal +spread glottis	*\textscn extsuperscript{h}\super w
ɴ̥ʷʰː	ɴ̥ʰʷː	uvular, labial:nasal:−voice +nasal +spread glottis	*\textscn extsuperscript{h}\super w\textlengthmark
ɴ̥ʷː	ɴ̥ʷː	uvular, labial:nasal:−voice +nasal	*\textscn\super w\textlengthmark
ɴ̥ː	ɴ̥ː	uvular:nasal:−voice +nasal	*\textscn\textlengthmark
ɴ̩	ɴ̩	uvular:nasal:+voice +nasal +syllabic	\textipa{\s{\textscn}}
ɴ̩ʲ	ɴ̩ʲ	uvular, palatal:nasal:+voice +nasal +syllabic	\textipa{\s{\textscn}}\super j
ɴ̩ʲː	ɴ̩ʲː	uvular, palatal:nasal:+voice +nasal +syllabic	\textipa{\s{\textscn}}\super j\textlengthmark
ɴ̩ʷ	ɴ̩ʷ	uvular, labial:nasal:+voice +nasal +syllabic	\textipa{\s{\textscn}}\super w
ɴ̩ʷː	ɴ̩ʷː	uvular, labial:nasal:+voice +nasal +syllabic	\textipa{\s{\textscn}}\super w\textlengthmark
ɴ̩ː	ɴ̩ː	uvular:nasal:+voice +nasal +syllabic	\textipa{\s{\textscn}}\textlengthmark
ɴ̩̥	ɴ̥̩	uvular:nasal:−voice +nasal +syllabic	\textipa{\s{ *\textscn}}
ɴ̩̥ʲ	ɴ̥̩ʲ	uvular, palatal:nasal:−voice +nasal +syllabic	\textipa{\s{ *\textscn}}\super j
ɴ̩̥ʲː	ɴ̥̩ʲː	uvular, palatal:nasal:−voice +nasal +syllabic	\textipa{\s{ *\textscn}}\super j\textlengthmark
ɴ̩̥ʷ	ɴ̥̩ʷ	uvular, labial:nasal:−voice +nasal +syllabic	\textipa{\s{ *\textscn}}\super w
ɴ̩̥ʷː	ɴ̥̩ʷː	uvular, labial:nasal:−voice +nasal +syllabic	\textipa{\s{ *\textscn}}\super w\textlengthmark
ɴ̩̥ː	ɴ̥̩ː	uvular:nasal:−voice +nasal +syllabic	\textipa{\s{ *\textscn}}\textlengthmark
ɵ	ɵ	empty:vowel:−high −low +back +round +voice −nasal −spread glottis −constricted glottis	\textbaro
ɵː	ɵː	empty:vowel:−high −low +back +round +voice −nasal −spread glottis −constricted glottis	\textbaro\textlengthmark
ɵ̃	ɵ̃	empty:vowel:−high −low +back +round +voice +nasal −spread glottis −constricted glottis	\textipa{\~\textbaro}
ɵ̃ː	ɵ̃ː	empty:vowel:−high −low +back +round +voice +nasal −spread glottis −constricted glottis	\textipa{\~\textbaro}\textlengthmark
ɵ̥	ɵ̥	empty:vowel:−high −low +back +round −voice −nasal −spread glottis −constricted glottis	*\textbaro
ɵ̥ː	ɵ̥ː	empty:vowel:−high −low +back +round −voice −nasal −spread glottis −constricted glottis	*\textbaro\textlengthmark
ɵ̥̃	ɵ̥̃	empty:vowel:−high −low +back +round −voice +nasal −spread glottis −constricted glottis	*\textipa{\~\textbaro}
ɵ̥̃ː	ɵ̥̃ː	empty:vowel:−high −low +back +round −voice +nasal −spread glottis −constricted glottis	*\textipa{\~\textbaro}\textlengthmark
ɵ̥̯	ɵ̯̥	empty:vowel:−high −low +back +round −voice −nasal −spread glottis −constricted glottis	*\textroundcap{\textbaro}
ɵ̥̯ː	ɵ̯̥ː	empty:vowel:−high −low +back +round −voice −nasal −spread glottis −constricted glottis	*\textroundcap{\textbaro}\textlengthmark
ɵ̥̯̃	ɵ̯̥̃	empty:vowel:−high −low +back +round −voice +nasal −spread glottis −constricted glottis	*\textipa{\~\textroundcap{\textbaro}}
ɵ̥̯̃ː	ɵ̯̥̃ː	empty:vowel:−high −low +back +round −voice +nasal −spread glottis −constricted glottis	*\textipa{\~\textroundcap{\textbaro}}\textlengthmark
ɵ̯	ɵ̯	empty:vowel:−high −low +back +round +voice −nasal −spread glottis −constricted glottis	\textroundcap{\textbaro}
ɵ̯ː	ɵ̯ː	empty:vowel:−high −low +back +round +voice −nasal −spread glottis −constricted glottis	\textroundcap{\textbaro}\textlengthmark
ɵ̯̃	ɵ̯̃	empty:vowel:−high −low +back +round +voice +nasal −spread glottis −constricted glottis	\textipa{\~\textroundcap{\textbaro}}
ɵ̯̃ː	ɵ̯̃ː	empty:vowel:−high −low +back +round +voice +nasal −spread glottis −constricted glottis	\textipa{\~\textroundcap{\textbaro}}\textlengthmark
ɶ	ɶ	empty:vowel:−high +low −back +round +voice −nasal −spread glottis −constricted glottis	\textscoelig
ɶː	ɶː	empty:vowel:−high +low −back +round +voice −nasal −spread glottis −constricted glottis	\textscoelig\textlengthmark
ɶ̃	ɶ̃	empty:vowel:−high +low −back +round +voice +nasal −spread glottis −constricted glottis	\textipa{\~\textscoelig}
ɶ̃ː	ɶ̃ː	empty:vowel:−high +low −back +round +voice +nasal −spread glottis −constricted glottis	\textipa{\~\textscoelig}\textlengthmark
ɶ̥	ɶ̥	empty:vowel:−high +low −back +round −voice −nasal −spread glottis −constricted glottis	*\textscoelig
ɶ̥ː	ɶ̥ː	empty:vowel:−high +low −back +round −voice −nasal −spread glottis −constricted glottis	*\textscoelig\textlengthmark
ɶ̥̃	ɶ̥̃	empty:vowel:−high +low −back +round −voice +nasal −spread glottis −constricted glottis	*\textipa{\~\textscoelig}
ɶ̥̃ː	ɶ̥̃ː	empty:vowel:−high +low −back +round −voice +nasal −spread glottis −constricted glottis	*\textipa{\~\textscoelig}\textlengthmark
ɶ̥̯	ɶ̯̥	empty:vowel:−high +low −back +round −voice −nasal −spread glottis −constricted glottis	*\textroundcap{\textscoelig}
ɶ̥̯ː	ɶ̯̥ː	empty:vowel:−high +low −back +round −voice −nasal −spread glottis −constricted glottis	*\textroundcap{\textscoelig}\textlengthmark
ɶ̥̯̃	ɶ̯̥̃	empty:vowel:−high +low −back +round −voice +nasal −spread glottis −constricted glottis	*\textipa{\~\textroundcap{\textscoelig}}
ɶ̥̯̃ː	ɶ̯̥̃ː	empty:vowel:−high +low −back +round −voice +nasal −spread glottis −constricted glottis	*\textipa{\~\textroundcap{\textscoelig}}\textlengthmark
ɶ̯	ɶ̯	empty:vowel:−high +low −back +round +voice −nasal −spread glottis −constricted glottis	\textroundcap{\textscoelig}
ɶ̯ː	ɶ̯ː	empty:vowel:−high +low −back +round +voice −nasal −spread glottis −constricted glottis	\textroundcap{\textscoelig}\textlengthmark
ɶ̯̃	ɶ̯̃	empty:vowel:−high +low −back +round +voice +nasal −spread glottis −constricted glottis	\textipa{\~\textroundcap{\textscoelig}}
ɶ̯̃ː	ɶ̯̃ː	empty:vowel:−high +low −back +round +voice +nasal −spread glottis −constricted glottis	\textipa{\~\textroundcap{\textscoelig}}\textlengthmark
ɸ	ɸ	labial:fricative:−voice	\textipa{F}
ɸʲ	ɸʲ	labial, palatal:fricative:−voice	\textipa{F}\super j
ɸʲː	ɸʲː	labial, palatal:fricative:−voice	\textipa{F}\super j\textlengthmark
ɸʷ	ɸʷ	labial:fricative:−voice	\textipa{F}\super w
ɸʷː	ɸʷː	labial:fricative:−voice	\textipa{F}\super w\textlengthmark
ɸː	ɸː	labial:fricative:−voice	\textipa{F}\textlengthmark
ɸ̩	ɸ̩	labial:fricative:−voice +syllabic	\textipa{\sF}
ɸ̩ʲ	ɸ̩ʲ	labial, palatal:fricative:−voice +syllabic	\textipa{\sF}\super j
ɸ̩ʲː	ɸ̩ʲː	labial, palatal:fricative:−voice +syllabic	\textipa{\sF}\super j\textlengthmark
ɸ̩ʷ	ɸ̩ʷ	labial:fricative:−voice +syllabic	\textipa{\sF}\super w
ɸ̩ʷː	ɸ̩ʷː	labial:fricative:−voice +syllabic	\textipa{\sF}\super w\textlengthmark
ɸ̩ː	ɸ̩ː	labial:fricative:−voice +syllabic	\textipa{\sF}\textlengthmark
ɹ	ɹ	alveolar:liquid:+voice −lateral	\textturnr
ɹʲ	ɹʲ	alveolar, palatal:liquid:+voice −lateral	\textturnr\super j
ɹ̠	ɹ̠	alveolar:liquid:+voice −lateral	\textsubbar{\textturnr}
ɹ̠ʲ	ɹ̠ʲ	alveolar, palatal:liquid:+voice −lateral	\textsubbar{\textturnr}\super j
ɹ̥	ɹ̥	alveolar:liquid:−voice −lateral	*\textturnr
ɹ̥ʲ	ɹ̥ʲ	alveolar, palatal:liquid:−voice −lateral	*\textturnr\super j
ɹ̩	ɹ̩	alveolar:liquid:+voice −lateral +syllabic	\textipa{\s{\textturnr}}
ɹ̩̥	ɹ̥̩	alveolar:liquid:−voice −lateral +syllabic	\textipa{\s{ *\textturnr}}
ɺ	ɺ	alveolar:liquid:+voice +lateral	\textturnlonglegr
ɺʲ	ɺʲ	alveolar, palatal:liquid:+voice +lateral	\textturnlonglegr\super j
ɺ̠	ɺ̠	alveolar:liquid:+voice +lateral	\textsubbar{\textturnlonglegr}
ɺ̠ʲ	ɺ̠ʲ	alveolar, palatal:liquid:+voice +lateral	\textsubbar{\textturnlonglegr}\super j
ɺ̥	ɺ̥	alveolar:liquid:−voice +lateral	*\textturnlonglegr
ɺ̥ʲ	ɺ̥ʲ	alveolar, palatal:liquid:−voice +lateral	*\textturnlonglegr\super j
ɺ̩	ɺ̩	alveolar:liquid:+voice +lateral +syllabic	\textipa{\s{\textturnlonglegr}}
ɺ̩̥	ɺ̥̩	alveolar:liquid:−voice +lateral +syllabic	\textipa{\s{ *\textturnlonglegr}}
ɻ	ɻ	retroflex:liquid:+voice −lateral	\textturnrrtail
ɻʲ	ɻʲ	retroflex, palatal:liquid:+voice −lateral	\textturnrrtail\super j
ɻ̥	ɻ̥	retroflex:liquid:−voice −lateral	*\textturnrrtail
ɻ̥ʲ	ɻ̥ʲ	retroflex, palatal:liquid:−voice −lateral	*\textturnrrtail\super j
ɻ̩	ɻ̩	retroflex:liquid:+voice −lateral +syllabic	\textipa{\s{\textturnrrtail}}
ɻ̩̥	ɻ̥̩	retroflex:liquid:−voice −lateral +syllabic	\textipa{\s{ *\textturnrrtail}}
ɽ	ɽ	retroflex:liquid:+voice −lateral	\textrtailr
ɽʲ	ɽʲ	retroflex, palatal:liquid:+voice −lateral	\textrtailr\super j
ɽ̥	ɽ̥	retroflex:liquid:−voice −lateral	*\textrtailr
ɽ̥ʲ	ɽ̥ʲ	retroflex, palatal:liquid:−voice −lateral	*\textrtailr\super j
ɽ̩	ɽ̩	retroflex:liquid:+voice −lateral +syllabic	\textipa{\s{\textrtailr}}
ɽ̩̥	ɽ̥̩	retroflex:liquid:−voice −lateral +syllabic	\textipa{\s{ *\textrtailr}}
ɾ	ɾ	alveolar:liquid:+voice −lateral	\textfishhookr
ɾʲ	ɾʲ	alveolar, palatal:liquid:+voice −lateral	\textfishhookr\super j
ɾ̠	ɾ̠	alveolar:liquid:+voice −lateral	\textsubbar{\textfishhookr}
ɾ̠ʲ	ɾ̠ʲ	alveolar, palatal:liquid:+voice −lateral	\textsubbar{\textfishhookr}\super j
ɾ̥	ɾ̥	alveolar:liquid:−voice −lateral	*\textfishhookr
ɾ̥ʲ	ɾ̥ʲ	alveolar, palatal:liquid:−voice −lateral	*\textfishhookr\super j
ɾ̩	ɾ̩	alveolar:liquid:+voice −lateral +syllabic	\textipa{\s{\textfishhookr}}
ɾ̩̥	ɾ̥̩	alveolar:liquid:−voice −lateral +syllabic	\textipa{\s{ *\textfishhookr}}
ɾ̪	ɾ̪	alveolar:liquid:+voice −lateral	\textsubbridge{\textfishhookr}
ɾ̪ʲ	ɾ̪ʲ	alveolar, palatal:liquid:+voice −lateral	\textsubbridge{\textfishhookr}\super j
ʀ	ʀ	uvular:liquid:+voice −lateral	\textscr
ʀʲ	ʀʲ	uvular, palatal:liquid:+voice −lateral	\textscr\super j
ʀ̥	ʀ̥	uvular:liquid:−voice −lateral	*\textscr
ʀ̥ʲ	ʀ̥ʲ	uvular, palatal:liquid:−voice −lateral	*\textscr\super j
ʀ̩	ʀ̩	uvular:liquid:+voice −lateral +syllabic	\textipa{\s{\textscr}}
ʀ̩̥	ʀ̥̩	uvular:liquid:−voice −lateral +syllabic	\textipa{\s{ *\textscr}}
ʁ	ʁ	uvular:fricative:+voice	\textipa{K}
ʁʲ	ʁʲ	uvular, palatal:fricative:+voice	\textipa{K}\super j
ʁʲː	ʁʲː	uvular, palatal:fricative:+voice	\textipa{K}\super j\textlengthmark
ʁʷ	ʁʷ	uvular, labial:fricative:+voice	\textipa{K}\super w
ʁʷː	ʁʷː	uvular, labial:fricative:+voice	\textipa{K}\super w\textlengthmark
ʁː	ʁː	uvular:fricative:+voice	\textipa{K}\textlengthmark
ʁ̩	ʁ̩	uvular:fricative:+voice +syllabic	\textipa{\sK}
ʁ̩ʲ	ʁ̩ʲ	uvular, palatal:fricative:+voice +syllabic	\textipa{\sK}\super j
ʁ̩ʲː	ʁ̩ʲː	uvular, palatal:fricative:+voice +syllabic	\textipa{\sK}\super j\textlengthmark
ʁ̩ʷ	ʁ̩ʷ	uvular, labial:fricative:+voice +syllabic	\textipa{\sK}\super w
ʁ̩ʷː	ʁ̩ʷː	uvular, labial:fricative:+voice +syllabic	\textipa{\sK}\super w\textlengthmark
ʁ̩ː	ʁ̩ː	uvular:fricative:+voice +syllabic	\textipa{\sK}\textlengthmark
ʂ	ʂ	retroflex:fricative:−voice	\textrtails
ʂʲ	ʂʲ	retroflex, palatal:fricative:−voice	\textrtails\super j
ʂʲː	ʂʲː	retroflex, palatal:fricative:−voice	\textrtails\super j\textlengthmark
ʂʷ	ʂʷ	retroflex, labial:fricative:−voice	\textrtails\super w
ʂʷː	ʂʷː	retroflex, labial:fricative:−voice	\textrtails\super w\textlengthmark
ʂː	ʂː	retroflex:fricative:−voice	\textrtails\textlengthmark
ʂ̩	ʂ̩	retroflex:fricative:−voice +syllabic	\textipa{\s{\textrtails}}
ʂ̩ʲ	ʂ̩ʲ	retroflex, palatal:fricative:−voice +syllabic	\textipa{\s{\textrtails}}\super j
ʂ̩ʲː	ʂ̩ʲː	retroflex, palatal:fricative:−voice +syllabic	\textipa{\s{\textrtails}}\super j\textlengthmark
ʂ̩ʷ	ʂ̩ʷ	retroflex, labial:fricative:−voice +syllabic	\textipa{\s{\textrtails}}\super w
ʂ̩ʷː	ʂ̩ʷː	retroflex, labial:fricative:−voice +syllabic	\textipa{\s{\textrtails}}\super w\textlengthmark
ʂ̩ː	ʂ̩ː	retroflex:fricative:−voice +syllabic	\textipa{\s{\textrtails}}\textlengthmark
ʃ	ʃ	palatoalveolar:fricative:−voice	\textipa{S}
ʃʲ	ʃʲ	palatoalveolar, palatal:fricative:−voice	\textipa{S}\super j
ʃʲː	ʃʲː	palatoalveolar, palatal:fricative:−voice	\textipa{S}\super j\textlengthmark
ʃʷ	ʃʷ	palatoalveolar, labial:fricative:−voice	\textipa{S}\super w
ʃʷː	ʃʷː	palatoalveolar, labial:fricative:−voice	\textipa{S}\super w\textlengthmark
ʃː	ʃː	palatoalveolar:fricative:−voice	\textipa{S}\textlengthmark
ʃ̩	ʃ̩	palatoalveolar:fricative:−voice +syllabic	\textipa{\sS}
ʃ̩ʲ	ʃ̩ʲ	palatoalveolar, palatal:fricative:−voice +syllabic	\textipa{\sS}\super j
ʃ̩ʲː	ʃ̩ʲː	palatoalveolar, palatal:fricative:−voice +syllabic	\textipa{\sS}\super j\textlengthmark
ʃ̩ʷ	ʃ̩ʷ	palatoalveolar, labial:fricative:−voice +syllabic	\textipa{\sS}\super w
ʃ̩ʷː	ʃ̩ʷː	palatoalveolar, labial:fricative:−voice +syllabic	\textipa{\sS}\super w\textlengthmark
ʃ̩ː	ʃ̩ː	palatoalveolar:fricative:−voice +syllabic	\textipa{\sS}\textlengthmark
ʈ	ʈ	retroflex:plosive:−voice	\textrtailt
ʈʂ	ʈ͡ʂ	retroflex:affricate:−voice	\t{\textrtailt \textrtails}
ʈʂʰ	ʈ͡ʂʰ	retroflex:affricate:−voice +spread glottis	\t{\textrtailt \textrtails} extsuperscript{h}
ʈʂʰː	ʈ͡ʂʰː	retroflex:affricate:−voice +spread glottis	\t{\textrtailt \textrtails} extsuperscript{h}\textlengthmark
ʈʂʲ	ʈ͡ʂʲ	retroflex, palatal:affricate:−voice	\t{\textrtailt \textrtails}\super j
ʈʂʲː	ʈ͡ʂʲː	retroflex, palatal:affricate:−voice	\t{\textrtailt \textrtails}\super j\textlengthmark
ʈʂʷ	ʈ͡ʂʷ	retroflex, labial:affricate:−voice	\t{\textrtailt \textrtails}\super w
ʈʂʷː	ʈ͡ʂʷː	retroflex, labial:affricate:−voice	\t{\textrtailt \textrtails}\super w\textlengthmark
ʈʂː	ʈ͡ʂː	retroflex:affricate:−voice	\t{\textrtailt \textrtails}\textlengthmark
ʈʰ	ʈʰ	retroflex:plosive:−voice +spread glottis	\textrtailt extsuperscript{h}
ʈʰː	ʈʰː	retroflex:plosive:−voice +spread glottis	\textrtailt extsuperscript{h}\textlengthmark
ʈʲ	ʈʲ	retroflex, palatal:plosive:−voice	\textrtailt\super j
ʈʲʰ	ʈʰʲ	retroflex, palatal:plosive:−voice +spread glottis	\textrtailt extsuperscript{h}\super j
ʈʲʰː	ʈʰʲː	retroflex, palatal:plosive:−voice +spread glottis	\textrtailt extsuperscript{h}\super j\textlengthmark
ʈʲː	ʈʲː	retroflex, palatal:plosive:−voice	\textrtailt\super j\textlengthmark
ʈʷ	ʈʷ	retroflex, labial:plosive:−voice	\textrtailt\super w
ʈʷʰ	ʈʰʷ	retroflex, labial:plosive:−voice +spread glottis	\textrtailt extsuperscript{h}\super w
ʈʷʰː	ʈʰʷː	retroflex, labial:plosive:−voice +spread glottis	\textrtailt extsuperscript{h}\super w\textlengthmark
ʈʷː	ʈʷː	retroflex, labial:plosive:−voice	\textrtailt\super w\textlengthmark
ʈː	ʈː	retroflex:plosive:−voice	\textrtailt\textlengthmark
ʈ̩	ʈ̩	retroflex:plosive:−voice +syllabic	\textipa{\s{\textrtailt}}
ʈ̩ʲ	ʈ̩ʲ	retroflex, palatal:plosive:−voice +syllabic	\textipa{\s{\textrtailt}}\super j
ʈ̩ʲː	ʈ̩ʲː	retroflex, palatal:plosive:−voice +syllabic	\textipa{\s{\textrtailt}}\super j\textlengthmark
ʈ̩ʷ	ʈ̩ʷ	retroflex, labial:plosive:−voice +syllabic	\textipa{\s{\textrtailt}}\super w
ʈ̩ʷː	ʈ̩ʷː	retroflex, labial:plosive:−voice +syllabic	\textipa{\s{\textrtailt}}\super w\textlengthmark
ʈ̩ː	ʈ̩ː	retroflex:plosive:−voice +syllabic	\textipa{\s{\textrtailt}}\textlengthmark
ʉ	ʉ	empty:vowel:+high −low +back +round +voice −nasal −spread glottis −constricted glottis	\textbaru
ʉː	ʉː	empty:vowel:+high −low +back +round +voice −nasal −spread glottis −constricted glottis	\textbaru\textlengthmark
ʉ̃	ʉ̃	empty:vowel:+high −low +back +round +voice +nasal −spread glottis −constricted glottis	\textipa{\~\textbaru}
ʉ̃ː	ʉ̃ː	empty:vowel:+high −low +back +round +voice +nasal −spread glottis −constricted glottis	\textipa{\~\textbaru}\textlengthmark
ʉ̥	ʉ̥	empty:vowel:+high −low +back +round −voice −nasal −spread glottis −constricted glottis	*\textbaru
ʉ̥ː	ʉ̥ː	empty:vowel:+high −low +back +round −voice −nasal −spread glottis −constricted glottis	*\textbaru\textlengthmark
ʉ̥̃	ʉ̥̃	empty:vowel:+high −low +back +round −voice +nasal −spread glottis −constricted glottis	*\textipa{\~\textbaru}
ʉ̥̃ː	ʉ̥̃ː	empty:vowel:+high −low +back +round −voice +nasal −spread glottis −constricted glottis	*\textipa{\~\textbaru}\textlengthmark
ʉ̥̯	ʉ̯̥	empty:vowel:+high −low +back +round −voice −nasal −spread glottis −constricted glottis	*\textroundcap{\textbaru}
ʉ̥̯ː	ʉ̯̥ː	empty:vowel:+high −low +back +round −voice −nasal −spread glottis −constricted glottis	*\textroundcap{\textbaru}\textlengthmark
ʉ̥̯̃	ʉ̯̥̃	empty:vowel:+high −low +back +round −voice +nasal −spread glottis −constricted glottis	*\textipa{\~\textroundcap{\textbaru}}
ʉ̥̯̃ː	ʉ̯̥̃ː	empty:vowel:+high −low +back +round −voice +nasal −spread glottis −constricted glottis	*\textipa{\~\textroundcap{\textbaru}}\textlengthmark
ʉ̯	ʉ̯	empty:vowel:+high −low +back +round +voice −nasal −spread glottis −constricted glottis	\textroundcap{\textbaru}
ʉ̯ː	ʉ̯ː	empty:vowel:+high −low +back +round +voice −nasal −spread glottis −constricted glottis	\textroundcap{\textbaru}\textlengthmark
ʉ̯̃	ʉ̯̃	empty:vowel:+high −low +back +round +voice +nasal −spread glottis −constricted glottis	\textipa{\~\textroundcap{\textbaru}}
ʉ̯̃ː	ʉ̯̃ː	empty:vowel:+high −low +back +round +voice +nasal −spread glottis −constricted glottis	\textipa{\~\textroundcap{\textbaru}}\textlengthmark
ʊ	ʊ	empty:vowel:+high −low +back +round +voice −nasal −spread glottis −constricted glottis	\textupsilon
ʊː	ʊː	empty:vowel:+high −low +back +round +voice −nasal −spread glottis −constricted glottis	\textupsilon\textlengthmark
ʊ̃	ʊ̃	empty:vowel:+high −low +back +round +voice +nasal −spread glottis −constricted glottis	\textipa{\~\textupsilon}
ʊ̃ː	ʊ̃ː	empty:vowel:+high −low +back +round +voice +nasal −spread glottis −constricted glottis	\textipa{\~\textupsilon}\textlengthmark
ʊ̥	ʊ̥	empty:vowel:+high −low +back +round −voice −nasal −spread glottis −constricted glottis	*\textupsilon
ʊ̥ː	ʊ̥ː	empty:vowel:+high −low +back +round −voice −nasal −spread glottis −constricted glottis	*\textupsilon\textlengthmark
ʊ̥̃	ʊ̥̃	empty:vowel:+high −low +back +round −voice +nasal −spread glottis −constricted glottis	*\textipa{\~\textupsilon}
ʊ̥̃ː	ʊ̥̃ː	empty:vowel:+high −low +back +round −voice +nasal −spread glottis −constricted glottis	*\textipa{\~\textupsilon}\textlengthmark
ʊ̥̯	ʊ̯̥	empty:vowel:+high −low +back +round −voice −nasal −spread glottis −constricted glottis	*\textroundcap{\textupsilon}
ʊ̥̯ː	ʊ̯̥ː	empty:vowel:+high −low +back +round −voice −nasal −spread glottis −constricted glottis	*\textroundcap{\textupsilon}\textlengthmark
ʊ̥̯̃	ʊ̯̥̃	empty:vowel:+high −low +back +round −voice +nasal −spread glottis −constricted glottis	*\textipa{\~\textroundcap{\textupsilon}}
ʊ̥̯̃ː	ʊ̯̥̃ː	empty:vowel:+high −low +back +round −voice +nasal −spread glottis −constricted glottis	*\textipa{\~\textroundcap{\textupsilon}}\textlengthmark
ʊ̯	ʊ̯	empty:vowel:+high −low +back +round +voice −nasal −spread glottis −constricted glottis	\textroundcap{\textupsilon}
ʊ̯ː	ʊ̯ː	empty:vowel:+high −low +back +round +voice −nasal −spread glottis −constricted glottis	\textroundcap{\textupsilon}\textlengthmark
ʊ̯̃	ʊ̯̃	empty:vowel:+high −low +back +round +voice +nasal −spread glottis −constricted glottis	\textipa{\~\textroundcap{\textupsilon}}
ʊ̯̃ː	ʊ̯̃ː	empty:vowel:+high −low +back +round +voice +nasal −spread glottis −constricted glottis	\textipa{\~\textroundcap{\textupsilon}}\textlengthmark
ʋ	ʋ	labiodental:liquid:+voice −lateral	\textscriptv
ʋʲ	ʋʲ	labiodental, palatal:liquid:+voice −lateral	\textscriptv\super j
ʋ̥	ʋ̥	labiodental:liquid:−voice −lateral	*\textscriptv
ʋ̥ʲ	ʋ̥ʲ	labiodental, palatal:liquid:−voice −lateral	*\textscriptv\super j
ʋ̩	ʋ̩	labiodental:liquid:+voice −lateral +syllabic	\textipa{\s{\textscriptv}}
ʋ̩̥	ʋ̥̩	labiodental:liquid:−voice −lateral +syllabic	\textipa{\s{ *\textscriptv}}
ʌ	ʌ	empty:vowel:−high −low +back −round +voice −nasal −spread glottis −constricted glottis	\textturnv
ʌː	ʌː	empty:vowel:−high −low +back −round +voice −nasal −spread glottis −constricted glottis	\textturnv\textlengthmark
ʌ̃	ʌ̃	empty:vowel:−high −low +back −round +voice +nasal −spread glottis −constricted glottis	\textipa{\~\textturnv}
ʌ̃ː	ʌ̃ː	empty:vowel:−high −low +back −round +voice +nasal −spread glottis −constricted glottis	\textipa{\~\textturnv}\textlengthmark
ʌ̥	ʌ̥	empty:vowel:−high −low +back −round −voice −nasal −spread glottis −constricted glottis	*\textturnv
ʌ̥ː	ʌ̥ː	empty:vowel:−high −low +back −round −voice −nasal −spread glottis −constricted glottis	*\textturnv\textlengthmark
ʌ̥̃	ʌ̥̃	empty:vowel:−high −low +back −round −voice +nasal −spread glottis −constricted glottis	*\textipa{\~\textturnv}
ʌ̥̃ː	ʌ̥̃ː	empty:vowel:−high −low +back −round −voice +nasal −spread glottis −constricted glottis	*\textipa{\~\textturnv}\textlengthmark
ʌ̥̯	ʌ̯̥	empty:vowel:−high −low +back −round −voice −nasal −spread glottis −constricted glottis	*\textroundcap{\textturnv}
ʌ̥̯ː	ʌ̯̥ː	empty:vowel:−high −low +back −round −voice −nasal −spread glottis −constricted glottis	*\textroundcap{\textturnv}\textlengthmark
ʌ̥̯̃	ʌ̯̥̃	empty:vowel:−high −low +back −round −voice +nasal −spread glottis −constricted glottis	*\textipa{\~\textroundcap{\textturnv}}
ʌ̥̯̃ː	ʌ̯̥̃ː	empty:vowel:−high −low +back −round −voice +nasal −spread glottis −constricted glottis	*\textipa{\~\textroundcap{\textturnv}}\textlengthmark
ʌ̯	ʌ̯	empty:vowel:−high −low +back −round +voice −nasal −spread glottis −constricted glottis	\textroundcap{\textturnv}
ʌ̯ː	ʌ̯ː	empty:vowel:−high −low +back −round +voice −nasal −spread glottis −constricted glottis	\textroundcap{\textturnv}\textlengthmark
ʌ̯̃	ʌ̯̃	empty:vowel:−high −low +back −round +voice +nasal −spread glottis −constricted glottis	\textipa{\~\textroundcap{\textturnv}}
ʌ̯̃ː	ʌ̯̃ː	empty:vowel:−high −low +back −round +voice +nasal −spread glottis −constricted glottis	\textipa{\~\textroundcap{\textturnv}}\textlengthmark
ʍ	ʍ	labial, velar:fricative:−voice	\textturnw
ʍʲ	ʍʲ	labial, velar, palatal:fricative:−voice	\textturnw\super j
ʍʲː	ʍʲː	labial, velar, palatal:fricative:−voice	\textturnw\super j\textlengthmark
ʍʷ	ʍʷ	labial, velar:fricative:−voice	\textturnw\super w
ʍʷː	ʍʷː	labial, velar:fricative:−voice	\textturnw\super w\textlengthmark
ʍː	ʍː	labial, velar:fricative:−voice	\textturnw\textlengthmark
ʍ̩	ʍ̩	labial, velar:fricative:−voice +syllabic	\textipa{\s{\textturnw}}
ʍ̩ʲ	ʍ̩ʲ	labial, velar, palatal:fricative:−voice +syllabic	\textipa{\s{\textturnw}}\super j
ʍ̩ʲː	ʍ̩ʲː	labial, velar, palatal:fricative:−voice +syllabic	\textipa{\s{\textturnw}}\super j\textlengthmark
ʍ̩ʷ	ʍ̩ʷ	labial, velar:fricative:−voice +syllabic	\textipa{\s{\textturnw}}\super w
ʍ̩ʷː	ʍ̩ʷː	labial, velar:fricative:−voice +syllabic	\textipa{\s{\textturnw}}\super w\textlengthmark
ʍ̩ː	ʍ̩ː	labial, velar:fricative:−voice +syllabic	\textipa{\s{\textturnw}}\textlengthmark
ʎ	ʎ	palatal:liquid:+voice +lateral	\begin{IPA} +\;G \end{IPA}
ʎʲ	ʎʲ	palatal:liquid:+voice +lateral	\begin{IPA} +\;G \end{IPA}\super j
ʎ̥	ʎ̥	palatal:liquid:−voice +lateral	*\begin{IPA} +\;G \end{IPA}
ʎ̥ʲ	ʎ̥ʲ	palatal:liquid:−voice +lateral	*\begin{IPA} +\;G \end{IPA}\super j
ʎ̩	ʎ̩	palatal:liquid:+voice +lateral +syllabic	\textipa{\s{\begin{IPA} +\;G \end{IPA}}}
ʎ̩̥	ʎ̥̩	palatal:liquid:−voice +lateral +syllabic	\textipa{\s{ *\begin{IPA} +\;G \end{IPA}}}
ʏ	ʏ	empty:vowel:+high −low −back +round +voice −nasal −spread glottis −constricted glottis	\textipa{Y}
ʏː	ʏː	empty:vowel:+high −low −back +round +voice −nasal −spread glottis −constricted glottis	\textipa{Y}\textlengthmark
ʏ̃	ʏ̃	empty:vowel:+high −low −back +round +voice +nasal −spread glottis −constricted glottis	\textipa{\~\textipa{Y}}
ʏ̃ː	ʏ̃ː	empty:vowel:+high −low −back +round +voice +nasal −spread glottis −constricted glottis	\textipa{\~\textipa{Y}}\textlengthmark
ʏ̥	ʏ̥	empty:vowel:+high −low −back +round −voice −nasal −spread glottis −constricted glottis	*\textipa{Y}
ʏ̥ː	ʏ̥ː	empty:vowel:+high −low −back +round −voice −nasal −spread glottis −constricted glottis	*\textipa{Y}\textlengthmark
ʏ̥̃	ʏ̥̃	empty:vowel:+high −low −back +round −voice +nasal −spread glottis −constricted glottis	*\textipa{\~\textipa{Y}}
ʏ̥̃ː	ʏ̥̃ː	empty:vowel:+high −low −back +round −voice +nasal −spread glottis −constricted glottis	*\textipa{\~\textipa{Y}}\textlengthmark
ʏ̥̯	ʏ̯̥	empty:vowel:+high −low −back +round −voice −nasal −spread glottis −constricted glottis	*\textroundcap{\textipa{Y}}
ʏ̥̯ː	ʏ̯̥ː	empty:vowel:+high −low −back +round −voice −nasal −spread glottis −constricted glottis	*\textroundcap{\textipa{Y}}\textlengthmark
ʏ̥̯̃	ʏ̯̥̃	empty:vowel:+high −low −back +round −voice +nasal −spread glottis −constricted glottis	*\textipa{\~\textroundcap{\textipa{Y}}}
ʏ̥̯̃ː	ʏ̯̥̃ː	empty:vowel:+high −low −back +round −voice +nasal −spread glottis −constricted glottis	*\textipa{\~\textroundcap{\textipa{Y}}}\textlengthmark
ʏ̯	ʏ̯	empty:vowel:+high −low −back +round +voice −nasal −spread glottis −constricted glottis	\textroundcap{\textipa{Y}}
ʏ̯ː	ʏ̯ː	empty:vowel:+high −low −back +round +voice −nasal −spread glottis −constricted glottis	\textroundcap{\textipa{Y}}\textlengthmark
ʏ̯̃	ʏ̯̃	empty:vowel:+high −low −back +round +voice +nasal −spread glottis −constricted glottis	\textipa{\~\textroundcap{\textipa{Y}}}
ʏ̯̃ː	ʏ̯̃ː	empty:vowel:+high −low −back +round +voice +nasal −spread glottis −constricted glottis	\textipa{\~\textroundcap{\textipa{Y}}}\textlengthmark
ʐ	ʐ	retroflex:fricative:+voice	\textrtailz
ʐʲ	ʐʲ	retroflex, palatal:fricative:+voice	\textrtailz\super j
ʐʲː	ʐʲː	retroflex, palatal:fricative:+voice	\textrtailz\super j\textlengthmark
ʐʷ	ʐʷ	retroflex, labial:fricative:+voice	\textrtailz\super w
ʐʷː	ʐʷː	retroflex, labial:fricative:+voice	\textrtailz\super w\textlengthmark
ʐː	ʐː	retroflex:fricative:+voice	\textrtailz\textlengthmark
ʐ̩	ʐ̩	retroflex:fricative:+voice +syllabic	\textipa{\s{\textrtailz}}
ʐ̩ʲ	ʐ̩ʲ	retroflex, palatal:fricative:+voice +syllabic	\textipa{\s{\textrtailz}}\super j
ʐ̩ʲː	ʐ̩ʲː	retroflex, palatal:fricative:+voice +syllabic	\textipa{\s{\textrtailz}}\super j\textlengthmark
ʐ̩ʷ	ʐ̩ʷ	retroflex, labial:fricative:+voice +syllabic	\textipa{\s{\textrtailz}}\super w
ʐ̩ʷː	ʐ̩ʷː	retroflex, labial:fricative:+voice +syllabic	\textipa{\s{\textrtailz}}\super w\textlengthmark
ʐ̩ː	ʐ̩ː	retroflex:fricative:+voice +syllabic	\textipa{\s{\textrtailz}}\textlengthmark
ʑ	ʑ	alveolar, palatal:fricative:+voice	\textctz
ʑʲ	ʑʲ	alveolar, palatal:fricative:+voice	\textctz\super j
ʑʲː	ʑʲː	alveolar, palatal:fricative:+voice	\textctz\super j\textlengthmark
ʑʷ	ʑʷ	alveolar, palatal, labial:fricative:+voice	\textctz\super w
ʑʷː	ʑʷː	alveolar, palatal, labial:fricative:+voice	\textctz\super w\textlengthmark
ʑː	ʑː	alveolar, palatal:fricative:+voice	\textctz\textlengthmark
ʑ̩	ʑ̩	alveolar, palatal:fricative:+voice +syllabic	\textipa{\s{\textctz}}
ʑ̩ʲ	ʑ̩ʲ	alveolar, palatal:fricative:+voice +syllabic	\textipa{\s{\textctz}}\super j
ʑ̩ʲː	ʑ̩ʲː	alveolar, palatal:fricative:+voice +syllabic	\textipa{\s{\textctz}}\super j\textlengthmark
ʑ̩ʷ	ʑ̩ʷ	alveolar, palatal, labial:fricative:+voice +syllabic	\textipa{\s{\textctz}}\super w
ʑ̩ʷː	ʑ̩ʷː	alveolar, palatal, labial:fricative:+voice +syllabic	\textipa{\s{\textctz}}\super w\textlengthmark
ʑ̩ː	ʑ̩ː	alveolar, palatal:fricative:+voice +syllabic	\textipa{\s{\textctz}}\textlengthmark
ʒ	ʒ	palatoalveolar:fricative:+voice	\textyogh
ʒʲ	ʒʲ	palatoalveolar, palatal:fricative:+voice	\textyogh\super j
ʒʲː	ʒʲː	palatoalveolar, palatal:fricative:+voice	\textyogh\super j\textlengthmark
ʒʷ	ʒʷ	palatoalveolar, labial:fricative:+voice	\textyogh\super w
ʒʷː	ʒʷː	palatoalveolar, labial:fricative:+voice	\textyogh\super w\textlengthmark
ʒː	ʒː	palatoalveolar:fricative:+voice	\textyogh\textlengthmark
ʒ̍	ʒ̩	palatoalveolar:fricative:+voice +syllabic	\textipa{\s{\textyogh}}
ʒ̩ʲ	ʒ̩ʲ	palatoalveolar, palatal:fricative:+voice +syllabic	\textipa{\s{\textyogh}}\super j
ʒ̩ʲː	ʒ̩ʲː	palatoalveolar, palatal:fricative:+voice +syllabic	\textipa{\s{\textyogh}}\super j\textlengthmark
ʒ̩ʷ	ʒ̩ʷ	palatoalveolar, labial:fricative:+voice +syllabic	\textipa{\s{\textyogh}}\super w
ʒ̩ʷː	ʒ̩ʷː	palatoalveolar, labial:fricative:+voice +syllabic	\textipa{\s{\textyogh}}\super w\textlengthmark
ʒ̩ː	ʒ̩ː	palatoalveolar:fricative:+voice +syllabic	\textipa{\s{\textyogh}}\textlengthmark
ʔ	ʔ	glottal:plosive:−voice	\textglotstop
ʔʰ	ʔʰ	glottal:plosive:−voice +spread glottis	\textglotstop extsuperscript{h}
ʔʰː	ʔʰː	glottal:plosive:−voice +spread glottis	\textglotstop extsuperscript{h}\textlengthmark
ʔʲ	ʔʲ	glottal, palatal:plosive:−voice	\textglotstop\super j
ʔʲʰ	ʔʰʲ	glottal, palatal:plosive:−voice +spread glottis	\textglotstop extsuperscript{h}\super j
ʔʲʰː	ʔʰʲː	glottal, palatal:plosive:−voice +spread glottis	\textglotstop extsuperscript{h}\super j\textlengthmark
ʔʲː	ʔʲː	glottal, palatal:plosive:−voice	\textglotstop\super j\textlengthmark
ʔʷ	ʔʷ	glottal, labial:plosive:−voice	\textglotstop\super w
ʔʷʰ	ʔʰʷ	glottal, labial:plosive:−voice +spread glottis	\textglotstop extsuperscript{h}\super w
ʔʷʰː	ʔʰʷː	glottal, labial:plosive:−voice +spread glottis	\textglotstop extsuperscript{h}\super w\textlengthmark
ʔʷː	ʔʷː	glottal, labial:plosive:−voice	\textglotstop\super w\textlengthmark
ʔː	ʔː	glottal:plosive:−voice	\textglotstop\textlengthmark
ʔ̩	ʔ̩	glottal:plosive:−voice +syllabic	\textipa{\s{\textglotstop}}
ʔ̩ʲ	ʔ̩ʲ	glottal, palatal:plosive:−voice +syllabic	\textipa{\s{\textglotstop}}\super j
ʔ̩ʲː	ʔ̩ʲː	glottal, palatal:plosive:−voice +syllabic	\textipa{\s{\textglotstop}}\super j\textlengthmark
ʔ̩ʷ	ʔ̩ʷ	glottal, labial:plosive:−voice +syllabic	\textipa{\s{\textglotstop}}\super w
ʔ̩ʷː	ʔ̩ʷː	glottal, labial:plosive:−voice +syllabic	\textipa{\s{\textglotstop}}\super w\textlengthmark
ʔ̩ː	ʔ̩ː	glottal:plosive:−voice +syllabic	\textipa{\s{\textglotstop}}\textlengthmark
ʕ	ʕ	pharyngeal:fricative:+voice	\textrevglotstop
ʕʲ	ʕʲ	pharyngeal, palatal:fricative:+voice	\textrevglotstop\super j
ʕʲː	ʕʲː	pharyngeal, palatal:fricative:+voice	\textrevglotstop\super j\textlengthmark
ʕʷ	ʕʷ	pharyngeal, labial:fricative:+voice	\textrevglotstop\super w
ʕʷː	ʕʷː	pharyngeal, labial:fricative:+voice	\textrevglotstop\super w\textlengthmark
ʕː	ʕː	pharyngeal:fricative:+voice	\textrevglotstop\textlengthmark
ʕ̩	ʕ̩	pharyngeal:fricative:+voice +syllabic	\textipa{\s{\textrevglotstop}}
ʕ̩ʲ	ʕ̩ʲ	pharyngeal, palatal:fricative:+voice +syllabic	\textipa{\s{\textrevglotstop}}\super j
ʕ̩ʲː	ʕ̩ʲː	pharyngeal, palatal:fricative:+voice +syllabic	\textipa{\s{\textrevglotstop}}\super j\textlengthmark
ʕ̩ʷ	ʕ̩ʷ	pharyngeal, labial:fricative:+voice +syllabic	\textipa{\s{\textrevglotstop}}\super w
ʕ̩ʷː	ʕ̩ʷː	pharyngeal, labial:fricative:+voice +syllabic	\textipa{\s{\textrevglotstop}}\super w\textlengthmark
ʕ̩ː	ʕ̩ː	pharyngeal:fricative:+voice +syllabic	\textipa{\s{\textrevglotstop}}\textlengthmark
ʙ	ʙ	labial:liquid:+voice −lateral	\textscb
ʙʲ	ʙʲ	labial, palatal:liquid:+voice −lateral	\textscb\super j
ʙ̥	ʙ̥	labial:liquid:−voice −lateral	*\textscb
ʙ̥ʲ	ʙ̥ʲ	labial, palatal:liquid:−voice −lateral	*\textscb\super j
ʙ̩	ʙ̩	labial:liquid:+voice −lateral +syllabic	\textipa{\s{\textscb}}
ʙ̩̥	ʙ̥̩	labial:liquid:−voice −lateral +syllabic	\textipa{\s{ *\textscb}}
ʛ	ʛ	uvular:plosive:+voice	\texthtscg
ʛʰ	ʛʰ	uvular:plosive:+voice +spread glottis	\texthtscg extsuperscript{h}
ʛʰː	ʛʰː	uvular:plosive:+voice +spread glottis	\texthtscg extsuperscript{h}\textlengthmark
ʛʲ	ʛʲ	uvular, palatal:plosive:+voice	\texthtscg\super j
ʛʲʰ	ʛʰʲ	uvular, palatal:plosive:+voice +spread glottis	\texthtscg extsuperscript{h}\super j
ʛʲʰː	ʛʰʲː	uvular, palatal:plosive:+voice +spread glottis	\texthtscg extsuperscript{h}\super j\textlengthmark
ʛʲː	ʛʲː	uvular, palatal:plosive:+voice	\texthtscg\super j\textlengthmark
ʛʷ	ʛʷ	uvular, labial:plosive:+voice	\texthtscg\super w
ʛʷʰ	ʛʰʷ	uvular, labial:plosive:+voice +spread glottis	\texthtscg extsuperscript{h}\super w
ʛʷʰː	ʛʰʷː	uvular, labial:plosive:+voice +spread glottis	\texthtscg extsuperscript{h}\super w\textlengthmark
ʛʷː	ʛʷː	uvular, labial:plosive:+voice	\texthtscg\super w\textlengthmark
ʛː	ʛː	uvular:plosive:+voice	\texthtscg\textlengthmark
ʛ̩	ʛ̩	uvular:plosive:+voice +syllabic	\textipa{\s{\texthtscg}}
ʛ̩ʲ	ʛ̩ʲ	uvular, palatal:plosive:+voice +syllabic	\textipa{\s{\texthtscg}}\super j
ʛ̩ʲː	ʛ̩ʲː	uvular, palatal:plosive:+voice +syllabic	\textipa{\s{\texthtscg}}\super j\textlengthmark
ʛ̩ʷ	ʛ̩ʷ	uvular, labial:plosive:+voice +syllabic	\textipa{\s{\texthtscg}}\super w
ʛ̩ʷː	ʛ̩ʷː	uvular, labial:plosive:+voice +syllabic	\textipa{\s{\texthtscg}}\super w\textlengthmark
ʛ̩ː	ʛ̩ː	uvular:plosive:+voice +syllabic	\textipa{\s{\texthtscg}}\textlengthmark
ʝ	ʝ	palatal:fricative:+voice	\textctj
ʝʲ	ʝʲ	palatal:fricative:+voice	\textctj\super j
ʝʲː	ʝʲː	palatal:fricative:+voice	\textctj\super j\textlengthmark
ʝʷ	ʝʷ	palatal, labial:fricative:+voice	\textctj\super w
ʝʷː	ʝʷː	palatal, labial:fricative:+voice	\textctj\super w\textlengthmark
ʝː	ʝː	palatal:fricative:+voice	\textctj\textlengthmark
ʝ̩	ʝ̩	palatal:fricative:+voice +syllabic	\textipa{\s{\textctj}}
ʝ̩ʲ	ʝ̩ʲ	palatal:fricative:+voice +syllabic	\textipa{\s{\textctj}}\super j
ʝ̩ʲː	ʝ̩ʲː	palatal:fricative:+voice +syllabic	\textipa{\s{\textctj}}\super j\textlengthmark
ʝ̩ʷ	ʝ̩ʷ	palatal, labial:fricative:+voice +syllabic	\textipa{\s{\textctj}}\super w
ʝ̩ʷː	ʝ̩ʷː	palatal, labial:fricative:+voice +syllabic	\textipa{\s{\textctj}}\super w\textlengthmark
ʝ̩ː	ʝ̩ː	palatal:fricative:+voice +syllabic	\textipa{\s{\textctj}}\textlengthmark
ʟ	ʟ	velar:liquid:+voice +lateral	\textscl
ʟʲ	ʟʲ	velar, palatal:liquid:+voice +lateral	\textscl\super j
ʟ̟	ʟ̟	velar:liquid:+voice +lateral	\begin{IPA}\|+\;L\end{ipa}
ʟ̟ʲ	ʟ̟ʲ	velar, palatal:liquid:+voice +lateral	\begin{IPA}\|+\;L\end{ipa}\super j
ʟ̠	ʟ̠	velar:liquid:+voice +lateral	\textsubbar{\textscl}
ʟ̠ʲ	ʟ̠ʲ	velar, palatal:liquid:+voice +lateral	\textsubbar{\textscl}\super j
ʟ̥	ʟ̥	velar:liquid:−voice +lateral	*\textscl
ʟ̥ʲ	ʟ̥ʲ	velar, palatal:liquid:−voice +lateral	*\textscl\super j
ʟ̩	ʟ̩	velar:liquid:+voice +lateral +syllabic	\textipa{\s{\textscl}}
ʟ̩̥	ʟ̥̩	velar:liquid:−voice +lateral +syllabic	\textipa{\s{ *\textscl}}
β	β	labial:fricative:+voice	\textipa{B}
βʲ	βʲ	labial, palatal:fricative:+voice	\textipa{B}\super j
βʲː	βʲː	labial, palatal:fricative:+voice	\textipa{B}\super j\textlengthmark
βʷ	βʷ	labial:fricative:+voice	\textipa{B}\super w
βʷː	βʷː	labial:fricative:+voice	\textipa{B}\super w\textlengthmark
βː	βː	labial:fricative:+voice	\textipa{B}\textlengthmark
β̩	β̩	labial:fricative:+voice +syllabic	\textipa{\sB}
β̩ʲ	β̩ʲ	labial, palatal:fricative:+voice +syllabic	\textipa{\sB}\super j
β̩ʲː	β̩ʲː	labial, palatal:fricative:+voice +syllabic	\textipa{\sB}\super j\textlengthmark
β̩ʷ	β̩ʷ	labial:fricative:+voice +syllabic	\textipa{\sB}\super w
β̩ʷː	β̩ʷː	labial:fricative:+voice +syllabic	\textipa{\sB}\super w\textlengthmark
β̩ː	β̩ː	labial:fricative:+voice +syllabic	\textipa{\sB}\textlengthmark
θ	θ	dental:fricative:−voice	\textipa{T}
θʲ	θʲ	dental, palatal:fricative:−voice	\textipa{T}\super j
θʲː	θʲː	dental, palatal:fricative:−voice	\textipa{T}\super j\textlengthmark
θʷ	θʷ	dental, labial:fricative:−voice	\textipa{T}\super w
θʷː	θʷː	dental, labial:fricative:−voice	\textipa{T}\super w\textlengthmark
θː	θː	dental:fricative:−voice	\textipa{T}\textlengthmark
θ̩	θ̩	dental:fricative:−voice +syllabic	\textipa{\sT}
θ̩ʲ	θ̩ʲ	dental, palatal:fricative:−voice +syllabic	\textipa{\sT}\super j
θ̩ʲː	θ̩ʲː	dental, palatal:fricative:−voice +syllabic	\textipa{\sT}\super j\textlengthmark
θ̩ʷ	θ̩ʷ	dental, labial:fricative:−voice +syllabic	\textipa{\sT}\super w
θ̩ʷː	θ̩ʷː	dental, labial:fricative:−voice +syllabic	\textipa{\sT}\super w\textlengthmark
θ̩ː	θ̩ː	dental:fricative:−voice +syllabic	\textipa{\sT}\textlengthmark
χ	χ	uvular:fricative:−voice	\textchi
χʲ	χʲ	uvular, palatal:fricative:−voice	\textchi\super j
χʲː	χʲː	uvular, palatal:fricative:−voice	\textchi\super j\textlengthmark
χʷ	χʷ	uvular, labial:fricative:−voice	\textchi\super w
χʷː	χʷː	uvular, labial:fricative:−voice	\textchi\super w\textlengthmark
χː	χː	uvular:fricative:−voice	\textchi\textlengthmark
χ̩	χ̩	uvular:fricative:−voice +syllabic	\textipa{\s{\textchi}}
χ̩ʲ	χ̩ʲ	uvular, palatal:fricative:−voice +syllabic	\textipa{\s{\textchi}}\super j
χ̩ʲː	χ̩ʲː	uvular, palatal:fricative:−voice +syllabic	\textipa{\s{\textchi}}\super j\textlengthmark
χ̩ʷ	χ̩ʷ	uvular, labial:fricative:−voice +syllabic	\textipa{\s{\textchi}}\super w
χ̩ʷː	χ̩ʷː	uvular, labial:fricative:−voice +syllabic	\textipa{\s{\textchi}}\super w\textlengthmark
χ̩ː	χ̩ː	uvular:fricative:−voice +syllabic	\textipa{\s{\textchi}}\textlengthmark
